transaction_date,narration,transaction_amount,balance,transaction_type
30/01/2017,NEFT/INTERSWITCHNG/Goodsandservices30012,6352.0,3207247.88,CREDIT
30/01/2017,NEFT/INTERSWITCHNG/Goodsandservices28012,7294.88,3214542.76,CREDIT
30/01/2017,NEFT/INTERSWITCHNG/Goodsandservices29012,8138.5,3222681.26,CREDIT
30/01/2017,NEFT/UNIFIED PAYMENTS/VISAPayment 30Jan,14986.75,3237668.01,CREDIT
30/01/2017,2612927/ CD RUTH BABA,515000.0,3752668.01,CREDIT
30/01/2017,Interbank + VAT Charge,420.0,3752248.01,DEBIT
30/01/2017,January//NEFT TRF TO IBRAHIMBAKO,1000000.0,2752248.01,DEBIT
31/01/2017,Zenith POS Settlement for 31/01/2017,9800.0,2762048.01,CREDIT
31/01/2017,NEFT/INTERSWITCHNG/Goodsandservices31012,11463.38,2773511.39,CREDIT
31/01/2017,Zenith POS Settlement Comm for31/01/2017,122.51,2773388.88,CREDIT
31/01/2017,STAMP DUTY CHARGE,1950.0,2771438.88,DEBIT
31/01/2017,Acct Maint. Fee + VAT,4812.04,2766626.84,DEBIT
10/02/2017,SMS Notification Charge Jan 2017,132.0,2766494.84,DEBIT
01/02/2017,NEFT/UNIFIED PAYMENTS/VISAPayment 31Jan,595.5,2767090.34,CREDIT
01/02/2017,Zenith POS Settlement for 01/02/2017,650.0,2767740.34,CREDIT
01/02/2017,DP3011925/ISHAKU PIUS,1060.0,2768800.34,CREDIT
01/02/2017,NEFT/INTERSWITCHNG/Goodsandservices01022,1836.13,2770636.47,CREDIT
01/02/2017,Zenith POS Settlement Comm for01/02/2017,8.13,2770628.34,CREDIT
02/02/2017,Zenith POS Settlement for 02/02/2017,4600.0,2777114.09,CREDIT
02/02/2017,NEFT/INTERSWITCHNG/Goodsandservices02022,12654.39,2789768.48,CREDIT
02/02/2017,Zenith POS Settlement Comm for02/02/2017,57.51,2789710.97,DEBIT
03/02/2017,NEFT/UNIFIED PAYMENTS/VISAPayment 03Feb,397.0,2790107.97,CREDIT
03/02/2017,Zenith POS Settlement for 03/02/2017,1450.0,2791557.97,CREDIT
03/02/2017,NEFT/INTERSWITCHNG/Goodsandservices03022,32504.38,2824062.35,CREDIT
03/02/2017,CD/MUHAMMED 2964252,177000.0,3001062.35,CREDIT
03/02/2017,Zenith POS Settlement Comm for03/02/2017,18.13,3001044.22,DEBIT
03/02/2017,Interbank + VAT Charge,105.0,3000939.22,DEBIT
03/02/2017,new nylon//NEFT TRF TOVIVO&TECH INDUSTRIES LIMITED,489500.0,2511439.22,DEBIT
06/02/2017,NEFT/INTERSWITCHNG/Goodsandservices04022,6600.14,2518039.36,CREDIT
06/02/2017,NEFT/INTERSWITCHNG/Goodsandservices06022,11264.88,2529304.24,CREDIT
06/02/2017,Zenith POS Settlement for 06/02/2017,15600.0,2544904.24,CREDIT
06/02/2017,NEFT/INTERSWITCHNG/Goodsandservices05022,19601.88,2564506.12,CREDIT
06/02/2017,DS1716433/DEP/ERUTH BABA,500000.0,3064506.12,CREDIT
06/02/2017,Interbank + VAT Charge,105.0,3064401.12,DEBIT
06/02/2017,Zenith POS Settlement Comm for06/02/2017,195.02,3064206.1,DEBIT
06/02/2017,last//NEFT TRF TO IBRAHIM  BAKO,603000.0,2461206.1,DEBIT
07/02/2017,NEFT/INTERSWITCHNG/Goodsandservices07022,11463.39,2472669.49,CREDIT
07/02/2017,NEFT/UNIFIED PAYMENTS/VISAPayment 06Feb,17716.12,2490385.61,CREDIT
08/02/2017,NEFT/UNIFIED PAYMENTS/VISAPayment 07Feb,496.25,2490881.86,CREDIT
08/02/2017,NEFT/UNIFIED PAYMENTS/VISAPayment 08Feb,744.38,2491626.24,CREDIT
08/02/2017,Zenith POS Settlement for 08/02/2017,2500.0,2494126.24,CREDIT
08/02/2017,NEFT/INTERSWITCHNG/Goodsandservices08022,6550.51,2500676.75,CREDIT
09/02/2017,NEFT/INTERSWITCHNG/Goodsandservices09022,1836.13,2502481.63,CREDIT
09/02/2017,NEFT/UNIFIED PAYMENTS/VISAPayment 09Feb,4317.38,2506799.01,CREDIT
09/02/2017,Zenith POS Settlement for 09/02/2017,16250.0,2523049.01,CREDIT
09/02/2017,CD/2956091/ATTAH SK,218000.0,2741049.01,CREDIT
09/02/2017,Zenith POS Settlement Comm for09/02/2017,203.14,2740845.87,CREDIT
10/02/2017,NEFT/UNIFIED PAYMENTS/VISAPayment 10Feb,347.38,2741193.25,CREDIT
10/02/2017,Zenith POS Settlement for 10/02/2017,6450.0,2747643.25,CREDIT
10/02/2017,NEFT/INTERSWITCHNG/Goodsandservices10022,7096.38,2754739.63,CREDIT
10/02/2017,Zenith POS Settlement Comm for10/02/2017,80.63,2754659.0,DEBIT
13/02/2017,NEFT/INTERSWITCHNG/Goodsandservices13022,3176.0,2757835.0,CREDIT
13/02/2017,NEFT/UNIFIED PAYMENTS/VISAPayment 13Feb,5607.62,2763442.62,CREDIT
13/02/2017,Zenith POS Settlement for 13/02/2017,7300.0,2770742.62,CREDIT
13/02/2017,NEFT/INTERSWITCHNG/Goodsandservices11022,9180.63,2779923.25,CREDIT
13/02/2017,NEFT/INTERSWITCHNG/Goodsandservices12022,15086.0,2795009.25,CREDIT
13/02/2017,CSHD EP1763114/ PIUS ISHAKU,651600.0,3446609.25,CREDIT
13/02/2017,Zenith POS Settlement Comm for13/02/2017,91.26,3446517.99,DEBIT
13/02/2017,Interbank + VAT Charge,105.0,3446412.99,DEBIT
13/02/2017,mix//NEFT TRF TO NUTRICHEMPROCUREMENT NIG LTD,480000.0,2966412.99,DEBIT
14/02/2017,NEFT/INTERSWITCHNG/Goodsandservices14022,3225.64,2969638.63,CREDIT
14/02/2017,NEFT/UNIFIED PAYMENTS/VISAPayment 14Feb,4069.25,2973707.88,CREDIT
14/02/2017,Zenith POS Settlement for 14/02/2017,12150.0,2985857.88,CREDIT
14/02/2017,Zenith POS Settlement Comm for14/02/2017,151.88,2985706.0,DEBIT
15/02/2017,NEFT/UNIFIED PAYMENTS/VISAPayment 15Feb,2779.0,2988485.0,CREDIT
15/02/2017,NEFT/INTERSWITCHNG/Goodsandservices15022,62329.0,3060664.0,CREDIT
15/02/2017,cd pius ishaku/ds 3256550,450000.0,3510664.0,CREDIT
15/02/2017,Zenith POS Settlement Comm for15/02/2017,123.13,3510540.87,DEBIT
16/02/2017,NEFT/UNIFIED PAYMENTS/VISAPayment 16Feb,5508.38,3516049.25,CREDIT
16/02/2017,Zenith POS Settlement for 16/02/2017,7000.0,3523049.25,CREDIT
16/02/2017,NEFT/INTERSWITCHNG/Goodsandservices16022,19552.26,3542601.51,CREDIT
16/02/2017,Zenith POS Settlement Comm for16/02/2017,87.51,3542514.0,DEBIT
16/02/2017,Interbank + VAT Charge,105.0,3542409.0,DEBIT
16/02/2017,Interbank + VAT Charge,105.0,3542304.0,DEBIT
16/02/2017,remaining//NEFT TRF TO SGKGLOBAL SHIPPING SERVICES,499914.0,3042390.0,DEBIT
16/02/2017,yogurt//NEFT TRF TO SGK GLOBALSHIPPING SERVICES,800000.0,2242390.0,DEBIT
17/02/2017,NEFT/UNIFIED PAYMENTS/VISAPayment 17Feb,2282.75,2244672.75,CREDIT
17/02/2017,Zenith POS Settlement for 17/02/2017,7350.0,2252022.75,CREDIT
17/02/2017,NEFT/INTERSWITCHNG/Goodsandservices17022,7940.0,2259962.75,CREDIT
17/02/2017,Zenith POS Settlement Comm for17/02/2017,91.88,2259870.87,DEBIT
20/02/2017,NEFT/UNIFIED PAYMENTS/VISAPayment 20Feb,6004.62,2265875.49,CREDIT
20/02/2017,NEFT/INTERSWITCHNG/Goodsandservices19022,6451.25,2272326.74,CREDIT
20/02/2017,Zenith POS Settlement for 20/02/2017,10350.0,2282676.74,CREDIT
20/02/2017,NEFT/INTERSWITCHNG/Goodsandservices20022,12455.89,2295132.63,CREDIT
20/02/2017,NEFT/INTERSWITCHNG/Goodsandservices18022,13547.64,2308680.27,CREDIT
20/02/2017,CD RUTH BABA 0109377,880000.0,3188680.27,CREDIT
20/02/2017,Zenith POS Settlement Comm for20/02/2017,129.39,3188550.88,DEBIT
21/02/2017,Zenith POS Settlement for 21/02/2017,2500.0,3191050.88,CREDIT
21/02/2017,NEFT/INTERSWITCHNG/Goodsandservices21022,14043.89,3213034.77,CREDIT
21/02/2017,Zenith POS Settlement Comm for21/02/2017,31.25,3213003.52,DEBIT
22/02/2017,Zenith POS Settlement for 22/02/2017,400.0,3213403.52,CREDIT
22/02/2017,NEFT/INTERSWITCHNG/Goodsandservices22022,1389.51,3214793.03,CREDIT
22/02/2017,NEFT/UNIFIED PAYMENTS/VISAPayment 22Feb,2729.38,3217522.41,CREDIT
22/02/2017,Zenith POS Settlement Comm for22/02/2017,5.0,3217517.41,DEBIT
23/02/2017,NEFT/UNIFIED PAYMENTS/VISAPayment 23Feb,5260.25,3222777.66,CREDIT
23/02/2017,Zenith POS Settlement for 23/02/2017,7250.0,3230027.66,CREDIT
23/02/2017,NEFT/INTERSWITCHNG/Goodsandservices23022,7989.63,3238017.29,CREDIT
23/02/2017,Zenith POS Settlement Comm for23/02/2017,90.63,3237926.66,DEBIT
24/02/2017,Zenith POS Settlement for 24/02/2017,400.0,3238326.66,CREDIT
24/02/2017,NEFT/INTERSWITCHNG/Goodsandservices24022,6649.75,3244976.41,CREDIT
24/02/2017,Zenith POS Settlement Comm for24/02/2017,5.0,3244971.41,DEBIT
26/02/2017,SMS Notification Charge Feb 2017,252.0,3244719.41,DEBIT
27/02/2017,NEFT/INTERSWITCHNG/Goodsandservices27022,5458.75,3250178.16,CREDIT
27/02/2017,NEFT/INTERSWITCHNG/Goodsandservices25022,11463.39,3261641.55,CREDIT
27/02/2017,NEFT/INTERSWITCHNG/Goodsandservices26022,29923.89,3291565.44,CREDIT
27/02/2017,DS5626217/CD RUTH BABA,515500.0,3807065.44,CREDIT
28/02/2017,NEFT/INTERSWITCHNG/Goodsandservices28022,2084.25,3809149.69,CREDIT
28/02/2017,Zenith POS Settlement for 28/02/2017,8150.0,3817299.69,CREDIT
28/02/2017,NEFT/UNIFIED PAYMENTS/VISAPayment 27Feb,9379.12,3826678.81,CREDIT
28/02/2017,NEFT/UNIFIED PAYMENTS/VISAPayment 28Feb,10570.12,3837248.93,CREDIT
28/02/2017,Zenith POS Settlement Comm for28/02/2017,101.89,3837147.04,DEBIT
28/02/2017,STAMP DUTY CHARGE,3250.0,3830878.98,CREDIT
01/03/2017,NEFT/UNIFIED PAYMENTS/VISAPayment 01Mar,1935.38,3832814.36,CREDIT
01/03/2017,Zenith POS Settlement for 01/03/2017,3550.0,3836364.36,CREDIT
01/03/2017,NEFT/INTERSWITCHNG/Goodsandservices01032,6401.63,3842765.99,CREDIT
01/03/2017,Zenith POS Settlement Comm for01/03/2017,44.38,3842721.61,CREDIT
01/03/2017,Interbank + VAT Charge,105.0,3842616.61,DEBIT
01/03/2017,wow//NEFT TRF TO IBRAHIM  BAKO,582000.0,3260616.61,DEBIT
02/03/2017,Zenith POS Settlement for 02/03/2017,13000.0,3273616.61,CREDIT
02/03/2017,NEFT/INTERSWITCHNG/Goodsandservices02032,15234.88,3288851.49,CREDIT
02/03/2017,Zenith POS Settlement Comm for02/03/2017,162.52,3288688.97,DEBIT
03/03/2017,NEFT/UNIFIED PAYMENTS/VISAPayment 02Mar,794.0,3289482.97,CREDIT
03/03/2017,Zenith POS Settlement for 03/03/2017,1200.0,3290682.97,CREDIT
03/03/2017,NEFT/UNIFIED PAYMENTS/VISAPayment 03Mar,1687.25,3292370.22,CREDIT
03/03/2017,NEFT/INTERSWITCHNG/Goodsandservices03032,5061.75,3297431.97,CREDIT
03/03/2017,Zenith POS Settlement Comm for03/03/2017,15.0,3297416.97,DEBIT
06/03/2017,NEFT/UNIFIED PAYMENTS/VISAPayment 05Mar,1191.0,3298607.97,CREDIT
06/03/2017,NEFT/UNIFIED PAYMENTS/VISAPayment 06Mar,3126.38,3301734.35,CREDIT
06/03/2017,NEFT/INTERSWITCHNG/Goodsandservices06032,5955.0,3307689.35,CREDIT
06/03/2017,Zenith POS Settlement for 06/03/2017,15250.0,3322939.35,CREDIT
06/03/2017,NEFT/INTERSWITCHNG/Goodsandservices06032,16078.5,3339017.85,CREDIT
06/03/2017,DS2225522/CD RUTH BABA,805000.0,4144017.85,CREDIT
06/03/2017,Zenith POS Settlement Comm for06/03/2017,190.63,4143827.22,DEBIT
07/03/2017,NEFT/INTERSWITCHNG/Goodsandservices07032,595.5,4144422.72,CREDIT
07/03/2017,Interbank + VAT Charge,105.0,4144317.72,DEBIT
08/03/2017,NEFT/INTERSWITCHNG/Goodsandservices08032,992.5,4045310.22,CREDIT
08/03/2017,Interbank + VAT Charge,420.0,4044890.22,DEBIT
08/03/2017,"save//NEFT TRF TO BABA, RUTHMAMA",1000000.0,3044890.22,DEBIT
09/03/2017,NEFT/UNIFIED PAYMENTS/VISAPayment 09Mar,1488.75,3046378.97,CREDIT
09/03/2017,Zenith POS Settlement for 09/03/2017,3600.0,3049978.97,CREDIT
09/03/2017,Zenith POS Settlement Comm for09/03/2017,45.0,3049933.97,DEBIT
10/03/2017,STAMP DUTY CHARGE,800.0,3049133.97,DEBIT
13/03/2017,NEFT/INTERSWITCHNG/Goodsandservices11032,7642.26,3056776.23,CREDIT
13/03/2017,NEFT/INTERSWITCHNG/Goodsandservices12032,9379.13,3066155.36,CREDIT
13/03/2017,Zenith POS Settlement for 13/03/2017,10350.0,3076505.36,CREDIT
13/03/2017,NEFT/UNIFIED PAYMENTS/VISAPayment 13Mar,13646.88,3090152.24,CREDIT
13/03/2017,NEFT/INTERSWITCHNG/Goodsandservices13032,14887.51,3105039.75,CREDIT
13/03/2017,DS 3346150 CD RUTH BABA,550000.0,3655039.75,CREDIT
13/03/2017,Zenith POS Settlement Comm for13/03/2017,129.39,3654910.36,DEBIT
14/03/2017,NEFT/UNIFIED PAYMENTS/VISAPayment 14Mar,2779.0,3657689.36,CREDIT
14/03/2017,Zenith POS Settlement for 14/03/2017,4400.0,3662089.36,CREDIT
14/03/2017,NEFT/INTERSWITCHNG/Goodsandservices14032,6947.5,3669036.86,CREDIT
14/03/2017,Zenith POS Settlement Comm for14/03/2017,55.0,3668981.86,DEBIT
14/03/2017,Interbank + VAT Charge,420.0,3668561.86,DEBIT
14/03/2017,bags of flour//NEFT TRF TO IBRAHIMBAKO,1695000.0,1973561.86,CREDIT
15/03/2017,NEFT/INTERSWITCHNG/Goodsandservices15032,1191.0,1974752.86,CREDIT
16/03/2017,Zenith POS Settlement for 16/03/2017,5850.0,1980602.86,CREDIT
16/03/2017,NEFT/INTERSWITCHNG/Goodsandservices16032,11562.63,1992165.49,CREDIT
17/03/2017,NEFT/INTERSWITCHNG/Goodsandservices17032,2282.75,1994375.11,CREDIT
17/03/2017,Zenith POS Settlement for 17/03/2017,2900.0,1997275.11,CREDIT
17/03/2017,Zenith POS Settlement Comm for17/03/2017,36.25,1997238.86,DEBIT
17/03/2017,STAMP DUTY CHARGE,700.0,1996538.86,DEBIT
17/03/2017,rvsl-VISA POS 15 03 2017,1488.75,1995050.11,DEBIT
20/03/2017,NEFT/UNIFIED PAYMENTS/VISAPayment 17Mar,2977.5,1998027.61,CREDIT
20/03/2017,NEFT/INTERSWITCHNG/Goodsandservices20032,3523.38,2001550.99,CREDIT
20/03/2017,NEFT/INTERSWITCHNG/Goodsandservices18032,7890.38,2009441.37,CREDIT
20/03/2017,Zenith POS Settlement for 20/03/2017,12200.0,2021641.37,CREDIT
20/03/2017,NEFT/INTERSWITCHNG/Goodsandservices19032,23919.26,2045560.63,CREDIT
20/03/2017,DS4036999/CD RUTH BABA,585000.0,2630560.63,CREDIT
20/03/2017,Zenith POS Settlement Comm for20/03/2017,152.52,2630408.11,DEBIT
21/03/2017,NEFT/INTERSWITCHNG/Goodsandservices21032,3374.5,2633782.61,CREDIT
21/03/2017,Zenith POS Settlement for 21/03/2017,3600.0,2637382.61,CREDIT
21/03/2017,NEFT/UNIFIED PAYMENTS/VISAPayment 20Mar,5359.5,2642742.11,CREDIT
21/03/2017,Zenith POS Settlement Comm for21/03/2017,45.0,2642697.11,DEBIT
22/03/2017,NEFT/UNIFIED PAYMENTS/VISAPayment 22Mar,595.5,2643292.61,CREDIT
22/03/2017,NEFT/UNIFIED PAYMENTS/VISAPayment 21Mar,1389.5,2644682.11,CREDIT
22/03/2017,Zenith POS Settlement for 22/03/2017,2000.0,2646682.11,CREDIT
22/03/2017,NEFT/INTERSWITCHNG/Goodsandservices22032,3771.5,2650453.61,CREDIT
22/03/2017,Zenith POS Settlement Comm for22/03/2017,25.0,2650428.61,DEBIT
23/03/2017,NEFT/INTERSWITCHNG/Goodsandservices23032,1389.5,2651818.11,CREDIT
24/03/2017,NEFT/UNIFIED PAYMENTS/VISAPayment 24Mar,2183.5,2654001.61,CREDIT
24/03/2017,NEFT/INTERSWITCHNG/Goodsandservices24032,20048.5,2676630.61,CREDIT
24/03/2017,SMS Notification Charge Mar 2017,192.0,2676438.61,DEBIT
24/03/2017,STAMP DUTY CHARGE,800.0,2675638.61,DEBIT
27/03/2017,NEFT/INTERSWITCHNG/Goodsandservices27032,992.5,2676631.11,CREDIT
27/03/2017,NEFT/UNIFIED PAYMENTS/VISAPayment 27Mar,1885.75,2678516.86,CREDIT
27/03/2017,Zenith POS Settlement for 27/03/2017,8050.0,2686566.86,CREDIT
27/03/2017,NEFT/INTERSWITCHNG/Goodsandservices25032,8436.25,2695003.11,CREDIT
27/03/2017,NEFT/INTERSWITCHNG/Goodsandservices26032,14540.13,2709543.24,CREDIT
27/03/2017,DS4030783/CD DEREKI SHUABI,610000.0,3319543.24,CREDIT
27/03/2017,Zenith POS Settlement Comm for27/03/2017,100.63,3319442.61,CREDIT
28/03/2017,NEFT/UNIFIED PAYMENTS/VISAPayment 27Mar,1091.75,3320534.36,CREDIT
28/03/2017,NEFT/INTERSWITCHNG/Goodsandservices28032,1985.0,3322519.36,CREDIT
28/03/2017,CD  RUTH BABA0901653,7220.0,3329739.36,CREDIT
29/03/2017,NEFT/UNIFIED PAYMENTS/VISAPayment 29Mar,1389.5,3331128.86,CREDIT
29/03/2017,Zenith POS Settlement for 29/03/2017,2000.0,3333128.86,CREDIT
29/03/2017,NEFT/INTERSWITCHNG/Goodsandservices29032,7146.01,3340274.87,CREDIT
29/03/2017,Zenith POS Settlement Comm for29/03/2017,25.0,3340249.87,DEBIT
30/03/2017,NEFT/UNIFIED PAYMENTS/VISAPayment 30Mar,1488.75,3341738.62,CREDIT
30/03/2017,Zenith POS Settlement for 30/03/2017,8200.0,3349938.62,CREDIT
30/03/2017,Zenith POS Settlement Comm for30/03/2017,102.5,3349836.12,DEBIT
31/03/2017,NEFT/UNIFIED PAYMENTS/VISAPayment 31Mar,6848.25,3356684.37,CREDIT
31/03/2017,Zenith POS Settlement for 31/03/2017,7700.0,3364384.37,CREDIT
31/03/2017,NEFT/INTERSWITCHNG/Goodsandservices31032,10619.75,3375004.12,CREDIT
31/03/2017,Zenith POS Settlement Comm for31/03/2017,96.25,3374907.87,DEBIT
31/03/2017,STAMP DUTY CHARGE,800.0,3373897.87,CREDIT
31/03/2017,Acct Maint. Fee + VAT,3630.88,3370266.99,DEBIT
31/03/2017,Duste//NEFT TRF TO N/A,36000.0,3334266.99,DEBIT
31/03/2017,Chicken//NEFT TRF TO GAZALIBARAU,42500.0,3291766.99,DEBIT
03/04/2017,NEFT/UNIFIED PAYMENTS/VISAPayment 03Apr,2084.25,3293851.24,CREDIT
03/04/2017,NEFT/INTERSWITCHNG/Goodsandservices03042,8833.25,3302684.49,CREDIT
03/04/2017,NEFT/INTERSWITCHNG/Goodsandservices02042,10818.25,3313502.74,CREDIT
03/04/2017,NEFT/INTERSWITCHNG/Goodsandservices01042,12704.0,3326206.74,CREDIT
03/04/2017,dp123060/ruth baba,715000.0,4041206.74,CREDIT
03/04/2017,Interbank + VAT Charge,105.0,4041101.74,DEBIT
03/04/2017,Interbank + VAT Charge,420.0,4040681.74,DEBIT
03/04/2017,RV Loc POS Prch-519911xxxx454602/04/2017,1985.0,4038696.74,DEBIT
03/04/2017,Instalation//NEFT TRF TO OGARCLEMENT OGABOR,10000.0,4028696.74,DEBIT
03/04/2017,"15 crates//NEFT TRF TO BELLO,SENORITA NANCY",13500.0,4015196.74,DEBIT
03/04/2017,"50kg,12.5kg//NEFT TRF TO UGWUEBENEZER",22500.0,3992696.74,DEBIT
03/04/2017,Repairs//NEFT TRF TO IBE GODWINNWACHUKWU,27000.0,3965696.74,DEBIT
03/04/2017,Lesson//NEFT TRF TO KALU .L.CHIKA,40000.0,3925696.74,DEBIT
04/04/2017,Zenith POS Settlement for 04/04/2017,4900.0,3930596.74,CREDIT
04/04/2017,NEFT/INTERSWITCHNG/Goodsandservices04042,7642.25,3938238.99,CREDIT
04/04/2017,NEFT RTD/N/A,36000.0,3974238.99,CREDIT
04/04/2017,Zenith POS Settlement Comm for04/04/2017,61.25,3974177.74,DEBIT
04/04/2017,Interbank + VAT Charge,105.0,3974072.74,DEBIT
04/04/2017,Interbank + VAT Charge,210.0,3973862.74,DEBIT
04/04/2017,12.5kg three//NEFT TRF TO UGWUEBENEZER,13500.0,3960362.74,DEBIT
04/04/2017,CHICKEN LAPS//TRF TO    SAYEDFARMS LTD-ABUJA A/C,146400.0,3791962.74,CREDIT
04/04/2017,Bread Leather//NEFT TRF TOVIVO&TECH INDUSTRIES LIMITED,350000.0,3441962.74,DEBIT
05/04/2017,NEFT/UNIFIED PAYMENTS/VISAPayment 05Apr,2183.5,3444146.24,CREDIT
05/04/2017,Zenith POS Settlement for 05/04/2017,7700.0,3451846.24,CREDIT
05/04/2017,DS4037221/CD RUTH BABA,336000.0,3787846.24,CREDIT
05/04/2017,Zenith POS Settlement Comm for05/04/2017,96.25,3787749.99,DEBIT
05/04/2017,Interbank + VAT Charge,105.0,3787644.99,DEBIT
05/04/2017,LICENCE//TRF TO VICTORBENEDICT IME,19000.0,3768644.99,DEBIT
05/04/2017,Duste refill//NEFT TRF TO UGWUEBENEZER,36000.0,3732644.99,DEBIT
05/04/2017,MARGARINE//TRF TO    EVMIRACLE BAKERS COMPANY NIGLTD,228500.0,3504144.99,DEBIT
06/04/2017,NEFT/INTERSWITCHNG/Goodsandservices06042,2183.5,3506328.49,CREDIT
06/04/2017,NEFT/UNIFIED PAYMENTS/VISAPayment 06Apr,4962.5,3511290.99,CREDIT
06/04/2017,Zenith POS Settlement for 06/04/2017,6000.0,3517290.99,CREDIT
06/04/2017,Zenith POS Settlement Comm for06/04/2017,75.0,3517215.99,DEBIT
06/04/2017,Interbank + VAT Charge,105.0,3517110.99,DEBIT
06/04/2017,Interbank + VAT Charge,105.0,3517005.99,DEBIT
06/04/2017,Transparent nylons//NEFT TRF TOAPEX PACKAGING LIMITED,15000.0,3502005.99,DEBIT
06/04/2017,50 chicken//NEFT TRF TO GAZALIBARAU,42500.0,3459505.99,DEBIT
07/04/2017,Zenith POS Settlement for 07/04/2017,3300.0,3462805.99,CREDIT
07/04/2017,NEFT/INTERSWITCHNG/Goodsandservices07042,4664.75,3467470.74,CREDIT
07/04/2017,NEFT/UNIFIED PAYMENTS/VISAPayment 07Apr,6550.5,3474021.24,CREDIT
07/04/2017,D1S008052/CD DEREK SHUAIB,450000.0,3924021.24,CREDIT
07/04/2017,Zenith POS Settlement Comm for07/04/2017,41.25,3923979.99,DEBIT
07/04/2017,Interbank + VAT Charge,105.0,3923874.99,DEBIT
07/04/2017,Crocker//NEFT TRF TO Ikechukwu,37000.0,3885974.99,CREDIT
10/04/2017,NEFT/UNIFIED PAYMENTS/VISAPayment 10Apr,1985.0,3887959.99,CREDIT
10/04/2017,NEFT/INTERSWITCHNG/Goodsandservices10042,4168.5,3892128.49,CREDIT
10/04/2017,NEFT/INTERSWITCHNG/Goodsandservices09042,6451.25,3898579.74,CREDIT
10/04/2017,NEFT/UNIFIED PAYMENTS/VISAPayment 09Apr,7146.0,3905725.74,CREDIT
10/04/2017,NEFT/INTERSWITCHNG/Goodsandservices08042,8237.75,3913963.49,CREDIT
10/04/2017,Zenith POS Settlement for 10/04/2017,11800.0,3925763.49,CREDIT
10/04/2017,RTD CROCKER\NEFT TRFIKECHUKWU,37000.0,3962763.49,CREDIT
10/04/2017,Interbank + VAT Charge,105.0,3962658.49,DEBIT
10/04/2017,Interbank + VAT Charge,105.0,3962553.49,DEBIT
10/04/2017,Zenith POS Settlement Comm for10/04/2017,147.5,3962405.99,DEBIT
10/04/2017,Consultation//NEFT TRF TO A.Y.USMAN CONSULTING LIMITED,37500.0,3924905.99,DEBIT
10/04/2017,Three 50kg  five 12.5kg//NEFT TRFTO UGWU EBENEZER,76500.0,3848405.99,DEBIT
11/04/2017,NEFT/INTERSWITCHNG/Goodsandservices11042,4664.75,3853070.74,CREDIT
11/04/2017,Zenith POS Settlement for 11/04/2017,6800.0,3859870.74,CREDIT
11/04/2017,ds4049069/cd ruth baba,235000.0,4094870.74,CREDIT
11/04/2017,Zenith POS Settlement Comm for11/04/2017,85.0,4094785.74,DEBIT
12/04/2017,NEFT/INTERSWITCHNG/Goodsandservices12042,3970.0,4098755.74,CREDIT
12/04/2017,Zenith POS Settlement for 12/04/2017,4500.0,4103255.74,CREDIT
12/04/2017,Zenith POS Settlement Comm for12/04/2017,56.25,4103199.49,DEBIT
12/04/2017,ISW CHARGE:ISW/135603456975/1014794871/15crates//LYDIA A OKUTEPA,100.0,4103099.49,DEBIT
12/04/2017,TIMER//TRF TO VICTOR BENEDICTIME,4500.0,4098599.49,DEBIT
13/04/2017,NEFT/INTERSWITCHNG/Goodsandservices13042,5161.0,4090260.49,CREDIT
13/04/2017,ISW CHARGE:ISW/135603460510/1014794871/Maintainance//IHEANACHO ANTHONYEWUZIE,100.0,4090160.49,DEBIT
13/04/2017,ISW CHARGE:ISW/135603460529/1014794871/250kg 3 12.5kg//UGWU EBENEZER,100.0,4090060.49,DEBIT
13/04/2017,"ISW CHARGE:ISW/135603462518/1014794871/Thank you//ALADESANMI, ADEBOWALE",100.0,4089960.49,DEBIT
13/04/2017,ISW/135603460510/1014794871/Maintainance//IHEANACHO ANTHONYEWUZIE,18000.0,4071960.49,DEBIT
13/04/2017,"ISW/135603462518/1014794871/Thank you//ALADESANMI, ADEBOWALE",20000.0,4051960.49,DEBIT
13/04/2017,ISW/135603460529/1014794871/250kg 3 12.5kg//UGWU EBENEZER,49500.0,4002460.49,DEBIT
13/04/2017,6 BAGS//TRF TO SAYED FARMSLTD-ABUJA A/C,160800.0,3841660.49,DEBIT
14/04/2017,ISW CHARGE:ISW/135603463324/1014794871/50local chickens//GAZALI BARAU,100.0,3841560.49,DEBIT
14/04/2017,STAMP DUTY CHARGE,650.0,3840910.49,DEBIT
14/04/2017,ISW/135603463324/1014794871/50local chickens//GAZALI BARAU,42500.0,3798410.49,DEBIT
16/04/2017,DR PAUL//TRF TO    EV MIRACLEBAKERS COMPANY NIG LTD,35000.0,3763410.49,DEBIT
18/04/2017,NEFT/INTERSWITCHNG/Goodsandservices15042,2183.5,3765593.99,CREDIT
18/04/2017,NEFT/INTERSWITCHNG/Goodsandservices18042,3176.0,3768769.99,CREDIT
18/04/2017,Zenith POS Settlement for 18/04/2017,3200.0,3771969.99,CREDIT
18/04/2017,NEFT/INTERSWITCHNG/Goodsandservices14042,4962.5,3776932.49,CREDIT
18/04/2017,NEFT/UNIFIED PAYMENTS/VISAPayment 17Apr,7642.25,3784574.74,CREDIT
18/04/2017,NEFT/INTERSWITCHNG/Goodsandservices17042,13001.75,3797576.49,CREDIT
18/04/2017,Zenith POS Settlement for 18/04/2017,17700.0,3815276.49,CREDIT
18/04/2017,Zenith POS Settlement Comm for18/04/2017,40.0,4915236.49,CREDIT
18/04/2017,ISW CHARGE:ISW/135603468500/1014794871/Mix//NUTRICHEM PROCUREMENT NIGLTD,100.0,4915136.49,DEBIT
18/04/2017,ISW CHARGE:ISW/135603469833/1014794871/Instal//OGAR CLEMENT OGABOR,100.0,4915036.49,DEBIT
18/04/2017,ISW CHARGE:ISW/135603470254/1014794871/Refill//UGWU EBENEZER,100.0,4914936.49,DEBIT
18/04/2017,Zenith POS Settlement Comm for18/04/2017,221.25,4914715.24,DEBIT
18/04/2017,ISW/135603469833/1014794871/Instal//OGAR CLEMENT OGABOR,20000.0,4894715.24,DEBIT
18/04/2017,ISW/135603470254/1014794871/Refill//UGWU EBENEZER,49500.0,4845215.24,DEBIT
18/04/2017,ISW/135603468500/1014794871/Mix//NUTRICHEM PROCUREMENT NIGLTD,634500.0,4210715.24,DEBIT
19/04/2017,NEFT/UNIFIED PAYMENTS/VISAPayment 18Apr,1191.0,4211906.24,CREDIT
19/04/2017,NEFT/INTERSWITCHNG/Goodsandservices19042,2084.25,4213990.49,CREDIT
19/04/2017,NEFT/INTERSWITCHNG/Goodsandservices16042,13101.0,4227091.49,CREDIT
19/04/2017,DS4159240/CD RUTH BABA,325000.0,4552091.49,CREDIT
20/04/2017,Rvsl:ISW CHARGE:ISW/135603475369/1014794871/Cable//ANEKE CHIJIOKE VAL,100.0,4552191.49,CREDIT
20/04/2017,NEFT/INTERSWITCHNG/Goodsandservices20042,2183.5,4554374.99,CREDIT
20/04/2017,Zenith POS Settlement for 20/04/2017,5300.0,4559674.99,CREDIT
20/04/2017,Rvsl:ISW/135603475369/1014794871/Cable//ANEKE CHIJIOKE VAL,11500.0,4571174.99,CREDIT
20/04/2017,Zenith POS Settlement Comm for20/04/2017,66.25,4571108.74,DEBIT
20/04/2017,ISW CHARGE:ISW/135603475010/1014794871/NEPA//JULIUS A OBARO,100.0,4570908.74,CREDIT
20/04/2017,ISW CHARGE:ISW/135603475369/1014794871/Cable//ANEKE CHIJIOKE VAL,100.0,4570808.74,DEBIT
20/04/2017,ISW/135603475369/1014794871/Cable//ANEKE CHIJIOKE VAL,11500.0,4559308.74,DEBIT
20/04/2017,ISW/135603475010/1014794871/NEPA//JULIUS A OBARO,30500.0,4528808.74,DEBIT
20/04/2017,ISW/135603475003/1014794871/Bread nylon//VIVO & TECH INDUSTRIESLTD,125000.0,4403808.74,DEBIT
21/04/2017,Zenith POS Settlement for 21/04/2017,2800.0,4406608.74,CREDIT
21/04/2017,NEFT/INTERSWITCHNG/Goodsandservices21042,6352.0,4412960.74,CREDIT
21/04/2017,Zenith POS Settlement Comm for21/04/2017,35.0,4412925.74,DEBIT
21/04/2017,ISW CHARGE:ISW/135603477662/1014794871/Eggs//LYDIA A OKUTEPA,100.0,4412825.74,DEBIT
21/04/2017,ISW CHARGE:ISW/135603478713/1014794871/Truck load//Ottah alexander,100.0,4412725.74,DEBIT
21/04/2017,ISW CHARGE:ISW/135603479324/1014794871/Forwork//AHMODU UMAR,100.0,4412625.74,DEBIT
21/04/2017,Interbank + VAT Charge,105.0,4412520.74,DEBIT
21/04/2017,SMS Notification Charge Apr 2017,324.0,4412196.74,DEBIT
21/04/2017,STAMP DUTY CHARGE,800.0,4411396.74,DEBIT
21/04/2017,ISW/135603479324/1014794871/Forwork//AHMODU UMAR,7500.0,4403896.74,DEBIT
21/04/2017,ISW/135603478713/1014794871/Truck load//Ottah alexander,13000.0,4390896.74,DEBIT
21/04/2017,ISW/135603477662/1014794871/Eggs//LYDIA A OKUTEPA,13500.0,4377396.74,DEBIT
21/04/2017,Duste and gwarimpa refill//NEFT TRFTO UGWU EBENEZER,67500.0,4309896.74,DEBIT
23/04/2017,6SACKS//TRF TO SAYED FARMSLTD-ABUJA A/C,140150.0,3707946.74,CREDIT
24/04/2017,"Rvsl:ISW CHARGE:ISW/135603485039/1014794871/Diesel//OBIEKEZIE,GODFRF0578",100.0,3708046.74,CREDIT
24/04/2017,Zenith POS Settlement for 24/04/2017,3800.0,3711846.74,CREDIT
24/04/2017,NEFT/INTERSWITCHNG/Goodsandservices24042,4565.5,3716412.24,CREDIT
24/04/2017,NEFT/UNIFIED PAYMENTS/VISAPayment 23Apr,8237.75,3724649.99,CREDIT
24/04/2017,NEFT/UNIFIED PAYMENTS/VISAPayment 24Apr,8783.62,3733433.61,CREDIT
24/04/2017,NEFT/INTERSWITCHNG/Goodsandservices22042,14788.25,3748221.86,CREDIT
24/04/2017,NEFT/INTERSWITCHNG/Goodsandservices23042,16326.63,3764548.49,CREDIT
24/04/2017,"Rvsl:ISW/135603485039/1014794871/Diesel//OBIEKEZIE,GODFRF0578",31920.0,3796468.49,CREDIT
24/04/2017,cd/ruth baba 342423,650550.0,4447018.49,CREDIT
24/04/2017,Zenith POS Settlement Comm for24/04/2017,47.5,4446970.99,DEBIT
24/04/2017,"ISW CHARGE:ISW/135603483337/1014794871/Service//THOMAS, GODWIN",100.0,4446870.99,DEBIT
24/04/2017,"ISW CHARGE:ISW/135603485039/1014794871/Diesel//OBIEKEZIE,GODFRF0578",100.0,4446770.99,DEBIT
24/04/2017,ISW CHARGE:ISW/135603485058/1014794871/Iteams//SUNDAY MICHIKA JOHN,100.0,4446670.99,DEBIT
24/04/2017,"ISW/135603483337/1014794871/Service//THOMAS, GODWIN",12000.0,4434670.99,DEBIT
24/04/2017,"ISW/135603485039/1014794871/Diesel//OBIEKEZIE,GODFRF0578",31920.0,4402750.99,DEBIT
24/04/2017,ISW/135603485058/1014794871/Iteams//SUNDAY MICHIKA JOHN,180300.0,4222450.99,DEBIT
25/04/2017,NEFT/INTERSWITCHNG/Goodsandservices25042,4069.25,4226520.24,CREDIT
25/04/2017,CD4020092/RUTH BABA,300820.0,4527340.24,CREDIT
26/04/2017,NEFT/INTERSWITCHNG/Goodsandservices26042,1091.75,4528431.99,CREDIT
26/04/2017,4154073/ CD RUTH BABA,50000.0,4581631.99,CREDIT
26/04/2017,Zenith POS Settlement Comm for26/04/2017,40.0,4581591.99,DEBIT
26/04/2017,ISW CHARGE:ISW/135603491751/1014794871/24th& 26th refill//UGWU EBENEZER,100.0,4581491.99,DEBIT
26/04/2017,ISW/135603491751/1014794871/24th& 26th refill//UGWU EBENEZER,81000.0,4500491.99,DEBIT
27/04/2017,Zenith POS Settlement for 27/04/2017,1100.0,4501591.99,CREDIT
27/04/2017,NEFT/UNIFIED PAYMENTS/VISAPayment 27Apr,1985.0,4503576.99,CREDIT
27/04/2017,NEFT/INTERSWITCHNG/Goodsandservices27042,3275.25,4506852.24,CREDIT
27/04/2017,D4S159418/CD RUTH BABA,220000.0,4726852.24,CREDIT
27/04/2017,Zenith POS Settlement Comm for27/04/2017,13.75,4726838.49,DEBIT
28/04/2017,Zenith POS Settlement for 28/04/2017,2300.0,4729138.49,CREDIT
28/04/2017,NEFT/INTERSWITCHNG/Goodsandservices28042,4466.25,4733604.74,CREDIT
28/04/2017,NEFT/UNIFIED PAYMENTS/VISAPayment 28Apr,10123.5,4743728.24,CREDIT
28/04/2017,D41S53420/CD RUTH BABA,342800.0,5086528.24,CREDIT
28/04/2017,Zenith POS Settlement Comm for28/04/2017,28.75,5086499.49,DEBIT
28/04/2017,STAMP DUTY CHARGE,1000.0,5085499.49,DEBIT
30/04/2017,Acct Maint. Fee + VAT,3532.93,5081966.56,CREDIT
01/05/2017,ISW CHARGE:ISW/135603507200/1014794871/Sausage and crocker//IKECHUKWU,100.0,5081866.56,DEBIT
01/05/2017,ISW/135603507200/1014794871/Sausage and crocker//IKECHUKWU,54000.0,5027866.56,DEBIT
02/05/2017,NEFT/INTERSWITCHNG/Goodsandservices01052,4664.75,5032531.31,CREDIT
02/05/2017,NEFT/UNIFIED PAYMENTS/POSPayment 01May2,5359.5,5037890.81,CREDIT
02/05/2017,NEFT/INTERSWITCHNG/Goodsandservices30042,7543.0,5045433.81,CREDIT
02/05/2017,Zenith POS Settlement for 02/05/2017,11300.0,5056733.81,CREDIT
02/05/2017,NEFT/INTERSWITCHNG/Goodsandservices29042,26499.75,5096334.56,CREDIT
02/05/2017,DS 0979740/CD RUTH BABA,1080120.0,6176454.56,CREDIT
02/05/2017,Zenith POS Settlement Comm for02/05/2017,141.25,6176313.31,DEBIT
02/05/2017,ICE CREAM FLAVOURS//TRF TODORIS U OGBONNA,85412.25,6090901.06,DEBIT
02/05/2017,6BAGS LAPS//TRF TO SAYEDFARMS LTD-ABUJA A/C,132720.0,5958181.06,DEBIT
03/05/2017,NEFT/INTERSWITCHNG/Goodsandservices03052,17269.5,5975450.56,CREDIT
03/05/2017,DS4049663/CD RUTH BABA,160000.0,6135450.56,CREDIT
03/05/2017,NIP/GTB/ONOJASON  GABRIELOJONUGWA/NIP FROM ONOJASONGABRIEL OJONUGWA TO WOW BA,175000.0,6310450.56,CREDIT
04/05/2017,Rvsl:ISW CHARGE:ISW/135603519783/1014794871/Local suya chicken//GAZALI BARAU,100.0,6310550.56,CREDIT
04/05/2017,NEFT/INTERSWITCHNG/Goodsandservices04052,992.5,6311543.06,CREDIT
04/05/2017,NEFT/UNIFIED PAYMENTS/POSPayment 04May2,1191.0,6312734.06,CREDIT
04/05/2017,Zenith POS Settlement for 04/05/2017,3800.0,6316534.06,CREDIT
04/05/2017,Rvsl:ISW/135603519783/1014794871/Local suya chicken//GAZALI BARAU,42500.0,6359034.06,CREDIT
04/05/2017,DS1011055 CD/ RUTH BABA,400000.0,6759034.06,CREDIT
04/05/2017,Zenith POS Settlement Comm for04/05/2017,47.5,6758986.56,DEBIT
04/05/2017,ISW CHARGE:ISW/135603517831/1014794871/Services//A.Y. USMAN CONSULTINGLIMITED,100.0,6758886.56,DEBIT
04/05/2017,ISW CHARGE:ISW/135603517901/1014794871/Keyboard//KALU .L. CHIKA,100.0,6758786.56,DEBIT
04/05/2017,ISW CHARGE:ISW/135603519778/1014794871/150bags//IBRAHIM  BAKO,100.0,6758686.56,DEBIT
04/05/2017,ISW/135603517831/1014794871/Services//A.Y. USMAN CONSULTINGLIMITED,20000.0,6738586.56,CREDIT
04/05/2017,ISW/135603517901/1014794871/Keyboard//KALU .L. CHIKA,40000.0,6698586.56,DEBIT
04/05/2017,ISW/135603519783/1014794871/Local suya chicken//GAZALI BARAU,42500.0,6656086.56,DEBIT
04/05/2017,MOORE BUTTER//TRF TO    EVMIRACLE BAKERS COMPANY NIGLTD,103500.0,6552586.56,DEBIT
04/05/2017,ISW/135603519778/1014794871/150bags//IBRAHIM  BAKO,1426500.0,5126086.56,DEBIT
05/05/2017,Rvsl:ISW CHARGE:ISW/135603521258/1014794871/Local syua chicken//GAZALI BARAU,100.0,5126186.56,CREDIT
05/05/2017,Zenith POS Settlement for 05/05/2017,1100.0,5127286.56,CREDIT
05/05/2017,NEFT/INTERSWITCHNG/Goodsandservices05052,2580.5,5129867.06,CREDIT
05/05/2017,Rvsl:ISW/135603521258/1014794871/Local syua chicken//GAZALI BARAU,42500.0,5172367.06,CREDIT
05/05/2017,DS1015955/CD/ PIUS ISHAKU,222725.0,5395092.06,CREDIT
05/05/2017,Zenith POS Settlement Comm for05/05/2017,13.75,5395078.31,DEBIT
05/05/2017,ISW CHARGE:ISW/135603521258/1014794871/Local syua chicken//GAZALI BARAU,100.0,5394978.31,DEBIT
05/05/2017,ISW CHARGE:ISW/135603521992/1014794871/Dvr//OGAR CLEMENT OGABOR,100.0,5394878.31,DEBIT
05/05/2017,ISW CHARGE:ISW/135603523457/1014794871/Generator service//IHEANACHOANTHONY EWU,100.0,5394778.31,DEBIT
05/05/2017,STAMP DUTY CHARGE,800.0,5393978.31,DEBIT
05/05/2017,ISW/135603521992/1014794871/Dvr//OGAR CLEMENT OGABOR,11500.0,5382478.31,DEBIT
05/05/2017,ISW/135603523457/1014794871/Generator service//IHEANACHOANTHONY EWUZIE,17000.0,5365478.31,DEBIT
05/05/2017,ISW/135603521258/1014794871/Local syua chicken//GAZALI BARAU,42500.0,5322978.31,DEBIT
08/05/2017,NEFT/INTERSWITCHNG/Goodsandservices08052,5061.75,5331513.81,CREDIT
08/05/2017,NEFT/UNIFIED PAYMENTS/VISAPayment 08May,7146.0,5338659.81,CREDIT
08/05/2017,NEFT/INTERSWITCHNG/Goodsandservices06052,10719.0,5349378.81,CREDIT
08/05/2017,NEFT/INTERSWITCHNG/Goodsandservices07052,13895.0,5363273.81,CREDIT
08/05/2017,Zenith POS Settlement for 08/05/2017,20600.0,5383873.81,CREDIT
08/05/2017,ISW CHARGE:ISW/135603528637/1014794871/Iceblock maker//GARBA IDRISDANJUMA,100.0,5383773.81,DEBIT
08/05/2017,Zenith POS Settlement Comm for08/05/2017,257.5,5383516.31,DEBIT
08/05/2017,ISW/135603528637/1014794871/Iceblock maker//GARBA IDRISDANJUMA,100000.0,5283516.31,DEBIT
09/05/2017,NEFT/UNIFIED PAYMENTS/POSPayment 09May2,1985.0,5285501.31,CREDIT
09/05/2017,NEFT/INTERSWITCHNG/Goodsandservices09052,6550.5,5292051.81,CREDIT
09/05/2017,DS87658/CD RUTH BABA,236000.0,5528051.81,CREDIT
10/05/2017,RvPosNtOnusTxnFE2000052606/04/2017,24.75,5528076.56,CREDIT
10/05/2017,Zenith POS Settlement for 10/05/2017,1100.0,5529176.56,CREDIT
10/05/2017,NEFT/INTERSWITCHNG/Goodsandservices10052,2183.5,5531360.06,CREDIT
10/05/2017,cd/pius ishaku 140917,315000.0,5846360.06,CREDIT
10/05/2017,Zenith POS Settlement Comm for10/05/2017,13.75,5846346.31,DEBIT
10/05/2017,RvPosNotOnusTxn2000052606/04/2017,3300.0,5843046.31,DEBIT
11/05/2017,NEFT/INTERSWITCHNG/Goodsandservices11052,3374.5,5846420.81,CREDIT
11/05/2017,Zenith POS Settlement for 11/05/2017,6900.0,5853320.81,CREDIT
11/05/2017,Zenith POS Settlement Comm for11/05/2017,86.25,5853234.56,DEBIT
11/05/2017,LAPS OF CHICKEN//TRF TO SAYEDFARMS LTD-ABUJA A/C,159000.0,5694234.56,DEBIT
12/05/2017,Zenith POS Settlement for 12/05/2017,8100.0,5704518.06,CREDIT
12/05/2017,ISW CHARGE:ISW/135603543677/1014794871/4small 2big//UGWU EBENEZER,100.0,5704418.06,DEBIT
12/05/2017,Zenith POS Settlement Comm for12/05/2017,101.25,5704316.81,DEBIT
12/05/2017,STAMP DUTY CHARGE,800.0,5703516.81,DEBIT
12/05/2017,rvsl-VISA POS 10 05 2017,3275.25,5700241.56,DEBIT
12/05/2017,ISW/135603543677/1014794871/4small 2big//UGWU EBENEZER,54000.0,5646241.56,DEBIT
14/05/2017,ISW CHARGE:ISW/135603545958/1014794871/Shop items//SUNDAY MICHIKA JOHN,100.0,5646141.56,DEBIT
14/05/2017,ISW CHARGE:ISW/135603546525/1014794871/15crates of eggs//MAJESTIC FARMSABUJA,100.0,5646041.56,DEBIT
14/05/2017,ISW/135603546525/1014794871/15crates of eggs//MAJESTIC FARMSABUJA,12750.0,5633291.56,DEBIT
14/05/2017,ISW/135603545958/1014794871/Shop items//SUNDAY MICHIKA JOHN,103400.0,5529891.56,DEBIT
15/05/2017,NEFT/INTERSWITCHNG/Goodsandservices14052,8138.5,5538030.06,CREDIT
15/05/2017,NEFT/INTERSWITCHNG/Goodsandservices15052,8833.25,5546863.31,CREDIT
15/05/2017,NIP/UBN/SOLOMON LB/NIB/UIP/001****179 TO WOWBAKERY CONFECTIONERY ANDPASTRIES,14000.0,5560863.31,CREDIT
15/05/2017,Zenith POS Settlement for 15/05/2017,14000.0,5574863.31,CREDIT
15/05/2017,NEFT/INTERSWITCHNG/Goodsandservices13052,18956.75,5593820.06,CREDIT
15/05/2017,DS25926/CD RUTH BABA/12-5-17,236500.0,5830320.06,CREDIT
15/05/2017,DS85752/CD RUTH BABA,257000.0,6087320.06,CREDIT
15/05/2017,ISW CHARGE:ISW/135603548350/1014794871/150bags flour//AKINOLA GBEMISOLASULIAT,100.0,6087220.06,DEBIT
15/05/2017,BREAD REQUIREMENTS//TRF TOEV MIRACLE BAKERS COMPANYNIG LTD,175600.0,5911445.06,CREDIT
15/05/2017,ISW/135603548350/1014794871/150bags flour//AKINOLA GBEMISOLASULIAT,1680000.0,4231445.06,DEBIT
16/05/2017,Zenith POS Settlement for 16/05/2017,2700.0,4234145.06,CREDIT
16/05/2017,NEFT/INTERSWITCHNG/Goodsandservices16052,6054.25,4240199.31,CREDIT
16/05/2017,DS253529/CD RUTH BABA,311475.0,4551674.31,CREDIT
16/05/2017,Zenith POS Settlement Comm for16/05/2017,33.75,4551640.56,DEBIT
16/05/2017,ISW CHARGE:ISW/135603551751/1014794871/Cooking gas refill//UGWU EBENEZER,100.0,4551540.56,DEBIT
16/05/2017,ISW CHARGE:ISW/135603553556/1014794871/Sweetner//CHINENYE JUDITH ONAH,100.0,4551440.56,DEBIT
16/05/2017,ISW/135603551751/1014794871/Cooking gas refill//UGWU EBENEZER,63000.0,4488440.56,DEBIT
16/05/2017,ISW/135603553556/1014794871/Sweetner//CHINENYE JUDITH ONAH,91250.0,4397190.56,DEBIT
17/05/2017,Zenith POS Settlement for 17/05/2017,4300.0,4401490.56,CREDIT
17/05/2017,NEFT/INTERSWITCHNG/Goodsandservices17052,5161.0,4406651.56,CREDIT
17/05/2017,Zenith POS Settlement Comm for17/05/2017,53.75,4406597.81,DEBIT
17/05/2017,ISW CHARGE:ISW/135603559648/1014794871/Crocker and gizzard//IKECHUKWU,100.0,4406497.81,DEBIT
17/05/2017,ISW/135603559648/1014794871/Crocker and gizzard//IKECHUKWU,70000.0,4336497.81,DEBIT
18/05/2017,Zenith POS Settlement for 18/05/2017,3000.0,4339497.81,CREDIT
18/05/2017,NEFT/INTERSWITCHNG/Goodsandservices18052,3176.0,4342673.81,CREDIT
18/05/2017,DS252133/CD RUTH BABA,350560.0,4693233.81,CREDIT
18/05/2017,Zenith POS Settlement Comm for18/05/2017,37.5,4693196.31,DEBIT
19/05/2017,Zenith POS Settlement for 19/05/2017,1000.0,4694196.31,CREDIT
19/05/2017,NEFT/INTERSWITCHNG/Goodsandservices19052,3473.75,4697670.06,CREDIT
19/05/2017,DS252128/CD RUTH BABA,1110500.0,6908670.06,CREDIT
19/05/2017,Zenith POS Settlement Comm for19/05/2017,12.5,6908657.56,DEBIT
19/05/2017,ISW CHARGE:ISW/135603567368/1014794871/100bags//IBRAHIM BAKO,100.0,6908557.56,DEBIT
19/05/2017,"ISW CHARGE:ISW/135603567691/1014794871/Nylon 50,000//VIVO&TECH INDUSTRIESLIMIT",100.0,6908457.56,DEBIT
19/05/2017,STAMP DUTY CHARGE,950.0,6907507.56,DEBIT
19/05/2017,"ISW/135603567691/1014794871/Nylon 50,000//VIVO&TECH INDUSTRIESLIMITED",475000.0,6432507.56,DEBIT
19/05/2017,ISW/135603567368/1014794871/100bags//IBRAHIM BAKO,1110000.0,5322507.56,DEBIT
19/05/2017,RVSL DS252128/CD RUTH BABA,1110500.0,4212007.56,DEBIT
21/05/2017,ISW ATMPyt-000180517919-PAIKOCASHPOINT 6      PAIKO        ,17000.0,4229007.56,CREDIT
22/05/2017,NEFT/INTERSWITCHNG/Goodsandservices21052,4367.0,4233374.56,CREDIT
22/05/2017,NEFT/INTERSWITCHNG/Goodsandservices22052,6550.5,4239925.06,CREDIT
22/05/2017,NEFT/INTERSWITCHNG/Goodsandservices20052,7642.25,4247567.31,CREDIT
22/05/2017,Zenith POS Settlement for 22/05/2017,20100.0,4267667.31,CREDIT
22/05/2017,cd/ruth baba 259811,579300.0,4846967.31,CREDIT
22/05/2017,Zenith POS Settlement Comm for22/05/2017,251.25,4846716.06,DEBIT
22/05/2017,REFUND//TRF TO IFEYINWAUKACHUKWU,3300.0,4843416.06,DEBIT
22/05/2017,SIX SACKS//TRF TO SAYED FARMSLTD-ABUJA A/C,152040.0,4691376.06,DEBIT
23/05/2017,NEFT/INTERSWITCHNG/Goodsandservices23052,4367.0,4695743.06,CREDIT
23/05/2017,Zenith POS Settlement for 23/05/2017,7100.0,4702843.06,CREDIT
23/05/2017,DS228365/CD RUTH BABA,170020.0,4872863.06,CREDIT
23/05/2017,Zenith POS Settlement Comm for23/05/2017,88.75,4872774.31,DEBIT
24/05/2017,NEFT/INTERSWITCHNG/Goodsandservices24052,3573.0,4878547.31,CREDIT
24/05/2017,trf frm Liz to WoW B for Cake,13000.0,4891547.31,CREDIT
24/05/2017,DS216800/CD RUTH BABA,275700.0,5167247.31,CREDIT
24/05/2017,Zenith POS Settlement Comm for24/05/2017,27.5,5167219.81,DEBIT
24/05/2017,ISW CHARGE:ISW/135603592911/1014794871/Materials for baking//ODOR FIDELISCHUKW,100.0,5167119.81,DEBIT
24/05/2017,ISW CHARGE:ISW/135603593295/1014794871/Stero//AGBAI CHUKWUDI JOSHUA,100.0,5167019.81,DEBIT
24/05/2017,ISW CHARGE:ISW/135603593461/1014794871/Sugar//IBRAHIM BAKO,100.0,5166919.81,DEBIT
24/05/2017,ISW/135603593295/1014794871/Stero//AGBAI CHUKWUDI JOSHUA,16000.0,5150919.81,DEBIT
24/05/2017,ISW/135603592911/1014794871/Materials for baking//ODOR FIDELISCHUKWUEMEKA,48800.0,5102119.81,DEBIT
24/05/2017,ISW/135603593461/1014794871/Sugar//IBRAHIM BAKO,178000.0,4924119.81,DEBIT
25/05/2017,Zenith POS Settlement for 25/05/2017,4300.0,4928419.81,CREDIT
25/05/2017,NEFT/INTERSWITCHNG/Goodsandservices25052,9925.0,4938344.81,CREDIT
25/05/2017,ds cd/ ruth baba,245350.0,5183694.81,CREDIT
25/05/2017,Zenith POS Settlement Comm for25/05/2017,53.75,5183641.06,DEBIT
26/05/2017,Rvsl:ISW CHARGE:ISW/135603603818/1014794871/Refillfor both locations//UGWU EBE,100.0,5183741.06,CREDIT
26/05/2017,Zenith POS Settlement for 26/05/2017,7300.0,5191041.06,CREDIT
26/05/2017,Rvsl:ISW/135603603818/1014794871/Refill for both locations//UGWUEBENEZER,63000.0,5254041.06,CREDIT
26/05/2017,DS54822/CDRUTH BABA,419100.0,5673141.06,CREDIT
26/05/2017,Zenith POS Settlement Comm for26/05/2017,91.25,5673049.81,DEBIT
26/05/2017,STAMP DUTY CHARGE,900.0,5672049.81,CREDIT
26/05/2017,CARRIER BAGS//TRF TO    123GLOBAL CONCEPTS,50000.0,5622049.81,DEBIT
26/05/2017,ISW/135603603818/1014794871/Refillfor both locations//UGWU EBENEZER,63000.0,5559049.81,DEBIT
28/05/2017,SMS Notification Charge May 2017,468.0,5558581.81,DEBIT
30/05/2017,Rvsl:ISW CHARGE:ISW/135603616481/1014794871/Gasfor duste and gwarimpa//UGWU EB,50.0,5558631.81,CREDIT
30/05/2017,NEFT/INTERSWITCHNG/Goodsandservices26052,4069.25,5562701.06,CREDIT
30/05/2017,NEFT/INTERSWITCHNG/Goodsandservices28052,4168.5,5566869.56,CREDIT
30/05/2017,NEFT/INTERSWITCHNG/Goodsandservices27052,5161.0,5572030.56,CREDIT
30/05/2017,NEFT/INTERSWITCHNG/Goodsandservices29052,6848.25,5578878.81,CREDIT
30/05/2017,NEFT/INTERSWITCHNG/Goodsandservices30052,12604.75,5591483.56,CREDIT
30/05/2017,Zenith POS Settlement for 30/05/2017,28500.0,5619983.56,CREDIT
30/05/2017,Rvsl:ISW/135603616481/1014794871/Gas for duste and gwarimpa//UGWUEBENEZER,49500.0,5669483.56,CREDIT
30/05/2017,cd/ruth baba 293522,1108290.0,6777773.56,CREDIT
30/05/2017,ISW CHARGE:ISW/135603616481/1014794871/Gasfor duste and gwarimpa//UGWUEBENEZE,50.0,6777723.56,DEBIT
30/05/2017,Zenith POS Settlement Comm for30/05/2017,356.25,6777367.31,DEBIT
30/05/2017,ISW/135603616481/1014794871/Gasfor duste and gwarimpa//UGWUEBENEZER,49500.0,6727867.31,DEBIT
31/05/2017,NEFT/INTERSWITCHNG/Goodsandservices31052,1091.75,6728959.06,CREDIT
31/05/2017,Zenith POS Settlement for 31/05/2017,2100.0,6731059.06,CREDIT
31/05/2017,DS 4090166/CD RUTH BABA,300250.0,7031309.06,CREDIT
31/05/2017,Zenith POS Settlement Comm for31/05/2017,26.25,7031282.81,DEBIT
31/05/2017,Acct Maint. Fee + VAT,6966.02,7024316.79,DEBIT
01/06/2017,Zenith POS Settlement for 01/06/2017,5700.0,7032498.04,CREDIT
01/06/2017,DS121694/CD RUTH BABA,305800.0,7338298.04,CREDIT
01/06/2017,ISW CHARGE:ISW/135603622541/1014794871/WOW mix//NUTRICHEMPROCUREMENT NIG LTD,50.0,7338248.04,DEBIT
01/06/2017,NIP Charge + VAT,52.5,7338195.54,DEBIT
01/06/2017,Zenith POS Settlement Comm for01/06/2017,71.25,7338124.29,DEBIT
01/06/2017,5NIP CR/UGWU EBENEZER/UNITY,49500.0,7288624.29,DEBIT
01/06/2017,LAPS 6SACKS//TRF TO SAYEDFARMS LTD-ABUJA A/C,151440.0,7137184.29,DEBIT
01/06/2017,ISW/135603622541/1014794871/WOW mix//NUTRICHEMPROCUREMENT NIG LTD,1240000.0,5897184.29,DEBIT
02/06/2017,Zenith POS Settlement for 02/06/2017,3300.0,5900484.29,CREDIT
02/06/2017,NEFT/INTERSWITCHNG/Goodsandservices02062,5359.5,5905843.79,CREDIT
02/06/2017,DS54829/CD RUTH BABA,330550.0,6236393.79,CREDIT
02/06/2017,Zenith POS Settlement Comm for02/06/2017,41.25,6236352.54,DEBIT
02/06/2017,ISW CHARGE:ISW/135603629353/1014794871/Yeast&butter//ODOR FIDELISCHUKWUEMEKA,50.0,6236302.54,DEBIT
02/06/2017,STAMP DUTY CHARGE,800.0,6235502.54,DEBIT
02/06/2017,ISW/135603629353/1014794871/Yeast&butter//ODOR FIDELISCHUKWUEMEKA,217500.0,6018002.54,DEBIT
05/06/2017,NEFT/INTERSWITCHNG/Goodsandservices03062,2183.5,6020186.04,CREDIT
05/06/2017,NEFT/INTERSWITCHNG/Goodsandservices05062,2183.5,6022369.54,CREDIT
05/06/2017,NEFT/INTERSWITCHNG/Goodsandservices04062,6352.0,6028721.54,CREDIT
05/06/2017,Zenith POS Settlement for 05/06/2017,10300.0,6039021.54,CREDIT
05/06/2017,DS67517/CD=RUTH BABA,742550.0,6781571.54,CREDIT
05/06/2017,ISW CHARGE:ISW/135603632289/1014794871/Preservative//ODOR FIDELISCHUKWUEMEKA,50.0,6781471.54,CREDIT
05/06/2017,"ISW CHARGE:ISW/135603633934/1014794871/Plainmayonise//JORPO, DOMINICSAATRE",50.0,6781421.54,DEBIT
05/06/2017,ISW CHARGE:ISW/135603635045/1014794871/Gizzard//IKECHUKWU,50.0,6781371.54,DEBIT
05/06/2017,Zenith POS Settlement Comm for05/06/2017,128.75,6781242.79,DEBIT
05/06/2017,"ISW/135603633934/1014794871/Plainmayonise//JORPO, DOMINICSAATRE",57500.0,6723742.79,DEBIT
05/06/2017,ISW/135603635045/1014794871/Gizzard//IKECHUKWU,59000.0,6664742.79,DEBIT
05/06/2017,ISW/135603632289/1014794871/Preservative//ODOR FIDELISCHUKWUEMEKA,135000.0,6529742.79,DEBIT
05/06/2017,ISW/135603632192/1014794871/Mama gold flour//IBRAHIM  BAKO,1680000.0,4849742.79,DEBIT
06/06/2017,Zenith POS Settlement for 06/06/2017,5500.0,4855242.79,CREDIT
06/06/2017,NEFT/INTERSWITCHNG/Goodsandservices06062,8932.5,4864175.29,CREDIT
06/06/2017,40023/CD/EMEKA,52500.0,4916675.29,CREDIT
06/06/2017,DS221043/CD RUTH BABA,426500.0,5343175.29,CREDIT
06/06/2017,ISW CHARGE:ISW/135603638824/1014794871/3big4small//UGWU EBENEZER,50.0,5343125.29,DEBIT
06/06/2017,Zenith POS Settlement Comm for06/06/2017,68.75,5343056.54,DEBIT
06/06/2017,ISW/135603638824/1014794871/3big4small//UGWU EBENEZER,72000.0,5271056.54,DEBIT
07/06/2017,NEFT/INTERSWITCHNG/Goodsandservices07062,2481.25,5273537.79,CREDIT
07/06/2017,Zenith POS Settlement for 07/06/2017,8800.0,5282337.79,CREDIT
07/06/2017,DS215812/CD RUTH BABA,223000.0,5505337.79,CREDIT
07/06/2017,CAKE BOXES//TRF TO ROYALEDUKES CO. LTD.,73000.0,5432227.79,CREDIT
08/06/2017,Zenith POS Settlement for 08/06/2017,1100.0,5433327.79,CREDIT
08/06/2017,NEFT/INTERSWITCHNG/Goodsandservices08062,16574.75,5449902.54,CREDIT
08/06/2017,Zenith POS Settlement Comm for08/06/2017,13.75,5449888.79,DEBIT
08/06/2017,ISW CHARGE:ISW/135603644551/1014794871/Bread&cake items//ODOR FIDELISCHUKWUEME,50.0,5449838.79,DEBIT
08/06/2017,ISW CHARGE:ISW/135603645051/1014794871/Dangote//SALIHU ABDULLAHI,50.0,5449788.79,DEBIT
08/06/2017,COCOA POWDER//TRF TOMEKANG RESOURCES & ALLIEDDISTRI. LTD,45000.0,5404788.79,DEBIT
08/06/2017,ISW/135603644551/1014794871/Bread&cake items//ODOR FIDELISCHUKWUEMEKA,97500.0,5307288.79,DEBIT
08/06/2017,ISW/135603645051/1014794871/Dangote//SALIHU ABDULLAHI,106800.0,5200488.79,DEBIT
09/06/2017,Zenith POS Settlement for 09/06/2017,6400.0,5206888.79,CREDIT
09/06/2017,NEFT/INTERSWITCHNG/Goodsandservices09062,8535.5,5215424.29,CREDIT
09/06/2017,DS221065/CD RUTH BABA,595000.0,5810424.29,CREDIT
09/06/2017,Zenith POS Settlement Comm for09/06/2017,80.0,5810344.29,DEBIT
09/06/2017,STAMP DUTY CHARGE,850.0,5809494.29,DEBIT
11/06/2017,ISW CHARGE:ISW/135603650636/1014794871/Duste repairs//IBE GODWINNWACHUKWU,50.0,5809444.29,DEBIT
11/06/2017,ISW CHARGE:ISW/135603651114/1014794871/Transportation//OROGADE OLALERE,50.0,5809394.29,DEBIT
11/06/2017,ISW/135603650636/1014794871/Duste repairs//IBE GODWINNWACHUKWU,30000.0,5779394.29,DEBIT
11/06/2017,DEMACATION WORK//TRF TOMOSES ALABI,80000.0,5699394.29,DEBIT
11/06/2017,CHICKEN FOR FOOD//TRF TOSAYED FARMS LTD-ABUJA A/C,138840.0,5453554.29,CREDIT
12/06/2017,NEFT/INTERSWITCHNG/Goodsandservices12062,3275.25,5456829.54,CREDIT
12/06/2017,NEFT/INTERSWITCHNG/Goodsandservices11062,3374.5,5460204.04,CREDIT
12/06/2017,NEFT/INTERSWITCHNG/Goodsandservices10062,11810.75,5472014.79,CREDIT
12/06/2017,Zenith POS Settlement for 12/06/2017,13900.0,5485914.79,CREDIT
12/06/2017,DS226378/CD RUTH BABA,803000.0,6288914.79,CREDIT
12/06/2017,ISW CHARGE:ISW/135603652831/1014794871/Plumbing//NASIRU HARUNA,50.0,6288864.79,DEBIT
12/06/2017,Zenith POS Settlement Comm for12/06/2017,173.75,6288691.04,DEBIT
12/06/2017,ISW/135603652831/1014794871/Plumbing//NASIRU HARUNA,30000.0,6258691.04,DEBIT
13/06/2017,Zenith POS Settlement for 13/06/2017,3300.0,6261991.04,CREDIT
13/06/2017,24421 CD/ EMEKA,150000.0,6411991.04,CREDIT
13/06/2017,Zenith POS Settlement Comm for13/06/2017,41.25,6411949.79,DEBIT
13/06/2017,ISW CHARGE:ISW/135603654621/1014794871/Bread pans//DALHATU NASURU,50.0,6411899.79,DEBIT
13/06/2017,ISW CHARGE:ISW/135603657350/1014794871/Work//KEHINDE  ADEYEMI,50.0,6411849.79,DEBIT
13/06/2017,ISW CHARGE:ISW/135603657364/1014794871/Purchases for last week//SUNDAYMICHIKA,50.0,6411799.79,DEBIT
13/06/2017,ISW/135603657350/1014794871/Work//KEHINDE  ADEYEMI,30000.0,6381799.79,DEBIT
13/06/2017,ISW/135603654621/1014794871/Bread pans//DALHATU NASURU,90000.0,6291799.79,DEBIT
13/06/2017,ISW/135603657364/1014794871/Purchases for last week//SUNDAYMICHIKA JOHN,180850.0,6110949.79,DEBIT
14/06/2017,Zenith POS Settlement for 14/06/2017,1100.0,6112049.79,CREDIT
14/06/2017,NEFT/INTERSWITCHNG/Goodsandservices14062,7741.5,6119791.29,CREDIT
14/06/2017,DS72741/CD RUTH BABA,340000.0,6659791.29,CREDIT
14/06/2017,Zenith POS Settlement Comm for14/06/2017,13.75,6659777.54,DEBIT
14/06/2017,DIGITAL PRINT//TRF TO JOHNPETER ABAH,145000.0,6514777.54,DEBIT
15/06/2017,Zenith POS Settlement for 15/06/2017,1400.0,6516177.54,CREDIT
15/06/2017,NEFT/INTERSWITCHNG/Goodsandservices15062,4466.25,6520643.79,CREDIT
15/06/2017,DS136917/CD RUTH BABA,280000.0,6800643.79,CREDIT
15/06/2017,Zenith POS Settlement Comm for15/06/2017,17.5,6800626.29,DEBIT
15/06/2017,ISW CHARGE:ISW/135603661146/1014794871/Cylinder refill duste and gwarimpa//UGWU,50.0,6800576.29,DEBIT
15/06/2017,ISW/135603661146/1014794871/Cylinder refill duste and gwarimpa//UGWUEBENEZER,49500.0,6751076.29,DEBIT
16/06/2017,NEFT/INTERSWITCHNG/Goodsandservices16062,5359.5,6756435.79,CREDIT
16/06/2017,Zenith POS Settlement for 16/06/2017,7400.0,6763835.79,CREDIT
16/06/2017,DS136882/CD RUTH BABA,150000.0,6913835.79,CREDIT
16/06/2017,ISW CHARGE:ISW/135603664405/1014794871/Installation//OLOWOLAFE AYOKUNLEOJO,50.0,6913785.79,DEBIT
16/06/2017,Zenith POS Settlement Comm for16/06/2017,92.5,6913693.29,DEBIT
16/06/2017,STAMP DUTY CHARGE,850.0,6912843.29,DEBIT
16/06/2017,ISW/135603664405/1014794871/Installation//OLOWOLAFE AYOKUNLEOJO,10000.0,6902843.29,DEBIT
18/06/2017,ISW CHARGE:ISW/135603667852/1014794871/For//NDAMAN MAMUDA ABDULHAMID,50.0,6902793.29,DEBIT
18/06/2017,ISW/135603667852/1014794871/For//NDAMAN MAMUDA ABDULHAMID,10000.0,6892793.29,DEBIT
19/06/2017,"Rvsl:ISW CHARGE:ISW/135603761550/1014794871/Sugar 20//SHIDOK,MARGARET61710",50.0,6892843.29,CREDIT
19/06/2017,NEFT/INTERSWITCHNG/Goodsandservices19062,8039.25,6903066.04,CREDIT
19/06/2017,NEFT/INTERSWITCHNG/Goodsandservices18062,8535.5,6911601.54,CREDIT
19/06/2017,Zenith POS Settlement for 19/06/2017,18100.0,6929701.54,CREDIT
19/06/2017,"Rvsl:ISW/135603761550/1014794871/Sugar 20//SHIDOK,MARGARET61710",354000.0,7283701.54,CREDIT
19/06/2017,cd ruth baba ds 61835,1059900.0,8343601.54,CREDIT
19/06/2017,ISW CHARGE:ISW/135603670388/1014794871/Duste flour//IBRAHIM BAKO,50.0,8343551.54,DEBIT
19/06/2017,"ISW CHARGE:ISW/135603761550/1014794871/Sugar 20//SHIDOK,MARGARET61710",50.0,8343501.54,DEBIT
19/06/2017,ISW CHARGE:ISW/135603791548/1014794871/Cylinder refill//UGWU EBENEZER,50.0,8343451.54,DEBIT
19/06/2017,Zenith POS Settlement Comm for19/06/2017,226.25,8343225.29,DEBIT
19/06/2017,ISW/135603791548/1014794871/Cylinder refill//UGWU EBENEZER,108000.0,8235225.29,DEBIT
19/06/2017,"ISW/135603761550/1014794871/Sugar 20//SHIDOK,MARGARET61710",354000.0,7881225.29,DEBIT
19/06/2017,ISW/135603670388/1014794871/Duste flour//IBRAHIM BAKO,1298000.0,6583225.29,DEBIT
20/06/2017,"Rvsl:ISW CHARGE:ISW/135604561797/1014794871/20bags sugar//SHIDOK,MARGARET61710",50.0,6583275.29,CREDIT
20/06/2017,Zenith POS Settlement for 20/06/2017,1300.0,6584575.29,CREDIT
20/06/2017,NEFT/INTERSWITCHNG/Goodsandservices20062,4267.75,6588843.04,CREDIT
20/06/2017,ds 2045250 derek shuaib,142600.0,6731443.04,CREDIT
20/06/2017,dp256679/ruth baba,350000.0,7081443.04,CREDIT
20/06/2017,"Rvsl:ISW/135604561797/1014794871/20bagssugar//SHIDOK,MARGARET61710",354000.0,7435443.04,CREDIT
20/06/2017,Zenith POS Settlement Comm for20/06/2017,16.25,7435426.79,DEBIT
20/06/2017,ISW CHARGE:ISW/135604561804/1014794871/Butter&yeast from lagos//ODOR FIDELISCH,50.0,7435326.79,CREDIT
20/06/2017,"ISW CHARGE:ISW/135604562746/1014794871/Supply 20bags sugar//SHIDOK, JOEL",50.0,7435276.79,DEBIT
20/06/2017,ISW CHARGE:ISW/135604563626/1014794871/Trays and pans//DALHATU NASURU,50.0,7435226.79,DEBIT
20/06/2017,ISW/135604563626/1014794871/Trays and pans//DALHATU NASURU,98000.0,7337226.79,DEBIT
20/06/2017,7 SACKS CHICKEN LAPS//TRF TOSAYED FARMS LTD-ABUJA A/C,177240.0,7159986.79,DEBIT
20/06/2017,"ISW/135604561797/1014794871/20bags sugar//SHIDOK,MARGARET61710",354000.0,6805986.79,DEBIT
20/06/2017,"ISW/135604562746/1014794871/Supply 20bags sugar//SHIDOK, JOEL",354000.0,6451986.79,DEBIT
20/06/2017,ISW/135604561804/1014794871/Butter&yeast from lagos//ODOR FIDELISCHUKWUEMEKA,436000.0,6015986.79,DEBIT
21/06/2017,NEFT/INTERSWITCHNG/Goodsandservices21062,1985.0,6017971.79,CREDIT
21/06/2017,CD/DEREK S/DS4174466,216250.0,6234221.79,CREDIT
21/06/2017,DS135964/CD RUTH BABA,225800.0,6460021.79,CREDIT
21/06/2017,ISW CHARGE:ISW/135604565132/1014794871/Flour mama gold//AKINOLA GBEMISOLASULIA,50.0,6459971.79,DEBIT
21/06/2017,ISW/135604565132/1014794871/Flour mama gold//AKINOLA GBEMISOLASULIAT,1000000.0,5459971.79,DEBIT
22/06/2017,Zenith POS Settlement for 22/06/2017,3600.0,5463571.79,CREDIT
22/06/2017,NEFT/INTERSWITCHNG/Goodsandservices22062,9925.0,5473496.79,CREDIT
22/06/2017,DS 12488 DEREK SHUIAB,130000.0,5603496.79,CREDIT
22/06/2017,Zenith POS Settlement Comm for22/06/2017,45.0,5603451.79,DEBIT
22/06/2017,ISW/135604568081/1014794871/Balance for flour//AKINOLA GBEMISOLASULIAT,848000.0,4755401.79,CREDIT
23/06/2017,NEFT/INTERSWITCHNG/Goodsandservices23062,4367.0,4759768.79,CREDIT
23/06/2017,Zenith POS Settlement for 23/06/2017,4700.0,4764468.79,CREDIT
23/06/2017,NIP/UBN/SOLOMON LB/NIB/UIP/001****179 TO WOWBAKERY CONFECTIONERY ANDPASTRIES,8000.0,4772468.79,CREDIT
23/06/2017,cd/madam chinyere 2440,50000.0,4822468.79,CREDIT
23/06/2017,CD/DEREK S./DS469864,520600.0,5343068.79,CREDIT
23/06/2017,Zenith POS Settlement Comm for23/06/2017,58.75,5343010.04,DEBIT
23/06/2017,SMS Notification Charge Jun 2017,376.0,5342634.04,DEBIT
23/06/2017,STAMP DUTY CHARGE,1000.0,5341634.04,DEBIT
25/06/2017,NIP/DBP/GODWIN DANIEL ETIM/NIP- TRF IFO WOW BAKERYCONFECTIONERY AND PASTRIESN,90000.0,5431634.04,CREDIT
25/06/2017,NIP/DBP/GODWIN DANIEL ETIM/NIP- TRF IFO WOW BAKERYCONFECTIONERY AND PASTRIESN,90000.0,5521634.04,CREDIT
25/06/2017,ISW CHARGE:ISW/135604575107/1014794871/Bus//MUSIBAU JIMOH,50.0,5521584.04,DEBIT
25/06/2017,ISW CHARGE:ISW/135604575775/1014794871/Busbalance//MUSIBAU JIMOH,50.0,5521534.04,DEBIT
25/06/2017,ISW CHARGE:ISW/135604576177/1014794871/Wood work//NWEKE UZOMA FRANCIS,50.0,5521484.04,DEBIT
25/06/2017,ISW/135604576177/1014794871/Wood work//NWEKE UZOMA FRANCIS,90000.0,5431484.04,DEBIT
25/06/2017,ISW/135604575775/1014794871/Busbalance//MUSIBAU JIMOH,1350000.0,4081484.04,DEBIT
25/06/2017,ISW/135604575107/1014794871/Bus//MUSIBAU JIMOH,1400000.0,2681484.04,DEBIT
27/06/2017,ISW/135604580473/1014794871/Cooling Fan//JIBRIN ODEKINA YUSUF,35000.0,2646434.04,CREDIT
28/06/2017,Rvsl:ISW CHARGE:ISW/135604582829/1014794871/Nylon for bread//VIVO&TECH INDUSTRI,50.0,2646484.04,CREDIT
28/06/2017,NEFT/INTERSWITCHNG/Goodsandservices27062,2183.5,2648667.54,CREDIT
28/06/2017,NEFT/INTERSWITCHNG/Goodsandservices25062,2183.5,2650851.04,CREDIT
28/06/2017,NEFT/INTERSWITCHNG/Goodsandservices26062,3870.75,2654721.79,CREDIT
28/06/2017,NEFT/INTERSWITCHNG/Goodsandservices24062,7344.5,2662066.29,CREDIT
28/06/2017,Zenith POS Settlement for 28/06/2017,11900.0,2673966.29,CREDIT
28/06/2017,Zenith POS Settlement for 28/06/2017,12100.0,2686066.29,CREDIT
28/06/2017,NEFT/INTERSWITCHNG/Goodsandservices28062,18659.0,2704725.29,CREDIT
28/06/2017,cd/madam chinyere ugwu 2216,50000.0,2754725.29,CREDIT
28/06/2017,CD/DERIC S/DS31656,193000.0,2947725.29,CREDIT
28/06/2017,Rvsl:ISW/135604582829/1014794871/Nylon for bread//VIVO&TECHINDUSTRIES LIMITED,400000.0,3347725.29,CREDIT
28/06/2017,DS118107/CD RUTH BABA,1537370.0,4885095.29,CREDIT
28/06/2017,ISW CHARGE:ISW/135604581928/1014794871/Bread net//KENNETH CHIBUZO OFFOR,50.0,4885045.29,DEBIT
28/06/2017,ISW CHARGE:ISW/135604581938/1014794871/Small and big cylinders//UGWUEBENEZER,50.0,4884995.29,DEBIT
28/06/2017,ISW CHARGE:ISW/135604582829/1014794871/Nylon for bread//VIVO&TECHINDUSTRIES LI,50.0,4884945.29,DEBIT
28/06/2017,ISW CHARGE:ISW/135604582866/1014794871/WOW bread nylon//YUSTECH POLY NIGENTERP,50.0,4884895.29,DEBIT
28/06/2017,Zenith POS Settlement Comm for28/06/2017,148.75,4884746.54,DEBIT
28/06/2017,ISW/135604581928/1014794871/Bread net//KENNETH CHIBUZO OFFOR,43200.0,4841395.29,CREDIT
28/06/2017,ISW/135604581938/1014794871/Small and big cylinders//UGWUEBENEZER,45000.0,4796395.29,DEBIT
28/06/2017,ISW/135604582829/1014794871/Nylon for bread//VIVO&TECHINDUSTRIES LIMITED,400000.0,4396395.29,DEBIT
28/06/2017,ISW/135604582866/1014794871/WOW bread nylon//YUSTECH POLY NIGENTERPRISES,400000.0,3996395.29,DEBIT
29/06/2017,Zenith POS Settlement for 29/06/2017,2200.0,3998595.29,CREDIT
29/06/2017,NIP/FDP/ZECHARIAH JOSEPHTHLAWUSON/ONB TRANSFERFROM ZECHARIAH  **3584 FBP,3000.0,4001595.29,CREDIT
29/06/2017,NEFT/INTERSWITCHNG/Goodsandservices29062,10222.75,4011818.04,CREDIT
29/06/2017,ds 207276 shuaib dexio,160000.0,4171818.04,CREDIT
29/06/2017,11101 CD VICTOR,246000.0,4417818.04,CREDIT
29/06/2017,NIP/DBP/GODWIN DANIEL ETIM/NIP- TRF IFO WOW BAKERYCONFECTIONERY AND PASTRIESN,1440000.0,5857818.04,CREDIT
29/06/2017,NIP/DBP/GODWIN DANIEL ETIM/NIP- TRF IFO WOW BAKERYCONFECTIONERY AND PASTRIESN,1440000.0,7297818.04,CREDIT
29/06/2017,Zenith POS Settlement Comm for29/06/2017,27.5,7297790.54,DEBIT
29/06/2017,ISW CHARGE:ISW/135604585737/1014794871/Cables//EMMANUEL O,50.0,7297740.54,DEBIT
29/06/2017,ISW/135604585737/1014794871/Cables//EMMANUEL O,48000.0,7249740.54,DEBIT
30/06/2017,Zenith POS Settlement for 30/06/2017,2100.0,7251840.54,CREDIT
30/06/2017,NEFT/INTERSWITCHNG/Goodsandservices30062,4565.5,7256406.04,CREDIT
30/06/2017,TRF FRM JOY TENI SHIAWOYA TOWOW BAKERY CONFECTIONERYAND PASTRIES NI,15000.0,7285406.04,CREDIT
30/06/2017,DS209766/CD RUTH BABA,210000.0,7495406.04,CREDIT
30/06/2017,Zenith POS Settlement Comm for30/06/2017,26.25,7495379.79,DEBIT
30/06/2017,ISW CHARGE:ISW/135604609147/1014794871/Gasburner//BAKERY SUPPORTSERVICES,50.0,7495329.79,DEBIT
30/06/2017,ISW CHARGE:ISW/135604611479/1014794871/Return money//GODWIN DANIEL ETIM,50.0,7495279.79,DEBIT
30/06/2017,STAMP DUTY CHARGE,1200.0,7494079.79,DEBIT
30/06/2017,Acct Maint. Fee + VAT,16293.1,7477786.69,DEBIT
30/06/2017,ISW/135604609147/1014794871/Gasburner//BAKERY SUPPORTSERVICES,350000.0,7127786.69,DEBIT
30/06/2017,ISW/135604611479/1014794871/Return money//GODWIN DANIEL ETIM,1440000.0,5687786.69,DEBIT
01/07/2017,NIP/DBP/IBRAHIM  ALI/NIP - TRFIFO WOW BAKERYCONFECTIONERY AND PASTRIESNIG LTD,2700.0,5690486.69,CREDIT
01/07/2017,ISW CHARGE:ISW/135604612627/1014794871/Gasrefill for 6cylinders//UGWUEBENEZER,50.0,5690436.69,DEBIT
01/07/2017,ISW/135604612627/1014794871/Gasrefill for 6cylinders//UGWUEBENEZER,60000.0,5630436.69,DEBIT
03/07/2017,NEFT/INTERSWITCHNG/Goodsandservices01072,5558.0,5635994.69,CREDIT
03/07/2017,NIP/FDP/ZECHARIAH JOSEPHTHLAWUSON/ONB TRANSFERFROM ZECHARIAH  **3584 FBP,7000.0,5642994.69,CREDIT
03/07/2017,NEFT/INTERSWITCHNG/Goodsandservices03072,11215.25,5654209.94,CREDIT
03/07/2017,Zenith POS Settlement for 03/07/2017,18500.0,5672709.94,CREDIT
03/07/2017,NEFT/INTERSWITCHNG/Goodsandservices02072,21438.0,5694147.94,CREDIT
03/07/2017,ds 208742 drrie shuaib,170000.0,5864147.94,CREDIT
03/07/2017,ISW CHARGE:ISW/135604614711/1014794871/Golden penny sugar//SHIDOK JOEL,50.0,6268097.94,CREDIT
03/07/2017,ISW CHARGE:ISW/135604614708/1014794871/Mamagold flour//IBRAHIM BAKO,50.0,6268047.94,DEBIT
03/07/2017,Zenith POS Settlement Comm for03/07/2017,231.25,6267816.69,DEBIT
03/07/2017,7SACKS LAPS//TRF TO SAYEDFARMS LTD-ABUJA A/C,128400.0,6139416.69,DEBIT
03/07/2017,ISW/135604614711/1014794871/Golden penny sugar//SHIDOK JOEL,786000.0,5353416.69,DEBIT
03/07/2017,ISW/135604614708/1014794871/Mamagold flour//IBRAHIM BAKO,1120000.0,4233416.69,DEBIT
04/07/2017,NEFT/INTERSWITCHNG/Goodsandservices04072,4367.0,4237783.69,CREDIT
04/07/2017,Zenith POS Settlement for 04/07/2017,5500.0,4243283.69,CREDIT
04/07/2017,DS209167/CD RUTH BABA,839500.0,5082783.69,CREDIT
04/07/2017,Zenith POS Settlement Comm for04/07/2017,68.75,5082714.94,DEBIT
05/07/2017,Rvsl:ISW CHARGE:ISW/135604625974/1014794871/Icecream supply//NKEMDILIM GEOFFRE,50.0,5082764.94,CREDIT
05/07/2017,Zenith POS Settlement for 05/07/2017,8800.0,5091564.94,CREDIT
05/07/2017,NEFT/INTERSWITCHNG/Goodsandservices05072,9031.75,5100596.69,CREDIT
05/07/2017,Rvsl:ISW/135604625974/1014794871/Ice cream supply//NKEMDILIMGEOFFREY ISAAC,96000.0,5196596.69,CREDIT
05/07/2017,CD/DEREK S/DS0941983,315000.0,5511596.69,CREDIT
05/07/2017,ISW CHARGE:ISW/135604623551/1014794871/Duste oven repairs//IBE GODWINNWACHUKWU,50.0,5511546.69,DEBIT
05/07/2017,ISW CHARGE:ISW/135604625974/1014794871/Icecream supply//NKEMDILIMGEOFFREY ISA,50.0,5511496.69,DEBIT
05/07/2017,Zenith POS Settlement Comm for05/07/2017,110.0,5511386.69,DEBIT
05/07/2017,ISW/135604625974/1014794871/Icecream supply//NKEMDILIMGEOFFREY ISAAC,96000.0,5407386.69,CREDIT
05/07/2017,ISW/135604623551/1014794871/Duste oven repairs//IBE GODWINNWACHUKWU,150000.0,5257386.69,DEBIT
06/07/2017,Rvsl:ISW CHARGE:ISW/135604627494/1014794871/3 icecream flavours//NKEMDILIM GEO,50.0,5257436.69,CREDIT
06/07/2017,NEFT/INTERSWITCHNG/Goodsandservices06072,3275.25,5260711.94,CREDIT
06/07/2017,Zenith POS Settlement for 06/07/2017,6800.0,5267511.94,CREDIT
06/07/2017,"NIP/GTB/UMANAH  KINGSLEYMONDAY/NIP FROM UMANAH,KINGSLEY MONDAY TO WOWBAKERY C",14000.0,5281511.94,CREDIT
06/07/2017,Rvsl:ISW/135604627494/1014794871/3 ice cream flavours//NKEMDILIMGEOFFREY ISAAC,96000.0,5377511.94,CREDIT
06/07/2017,ISW CHARGE:ISW/135604627494/1014794871/3 icecream flavours//NKEMDILIMGEOFFREY,50.0,5377461.94,DEBIT
06/07/2017,ISW CHARGE:ISW/135604628651/1014794871/Baking items from lagos//ODOR FIDELISCH,50.0,5377411.94,DEBIT
06/07/2017,Zenith POS Settlement Comm for06/07/2017,85.0,5377326.94,DEBIT
06/07/2017,ISW/135604627494/1014794871/3 icecream flavours//NKEMDILIMGEOFFREY ISAAC,96000.0,5281326.94,DEBIT
06/07/2017,"VANILLA,STRAWBERRY,CHOCOLATE//TRF TO ISAAC G NKEMDILIM",96000.0,5185326.94,DEBIT
06/07/2017,ISW/135604628651/1014794871/Baking items from lagos//ODOR FIDELISCHUKWUEMEKA,407700.0,4777626.94,DEBIT
07/07/2017,Zenith POS Settlement for 07/07/2017,1100.0,4778726.94,CREDIT
07/07/2017,NEFT/INTERSWITCHNG/Goodsandservices07072,15185.25,4793912.19,CREDIT
07/07/2017,CD/DEREK S/DS208106,150000.0,4943912.19,CREDIT
07/07/2017,Zenith POS Settlement Comm for07/07/2017,13.75,5165448.44,CREDIT
07/07/2017,ISW CHARGE:ISW/135604631029/1014794871/Supply of gas//VICTORIA PETER IKANI,50.0,5165398.44,DEBIT
07/07/2017,ISW CHARGE:ISW/135604631180/1014794871/Duste flour suppy//IBRAHIM  BAKO,50.0,5165348.44,DEBIT
07/07/2017,STAMP DUTY CHARGE,1050.0,5164298.44,DEBIT
07/07/2017,ISW/135604631029/1014794871/Supply of gas//VICTORIA PETER IKANI,44000.0,5120298.44,DEBIT
07/07/2017,ISW/135604631180/1014794871/Duste flour suppy//IBRAHIM  BAKO,996800.0,4123498.44,CREDIT
10/07/2017,NEFT/INTERSWITCHNG/Goodsandservices10072,5955.0,4129453.44,CREDIT
10/07/2017,NEFT/INTERSWITCHNG/Goodsandservices08072,7840.75,4137294.19,CREDIT
10/07/2017,CD/D SHUAIB/DS1573059,300000.0,4437294.19,CREDIT
10/07/2017,DS126219/CD RUTH BABA,584700.0,5021994.19,CREDIT
10/07/2017,ISW CHARGE:ISW/135604636881/1014794871/Mould and pruffons//THADDEUS DAVID,50.0,5021944.19,DEBIT
10/07/2017,ISW/135604636881/1014794871/Mould and pruffons//THADDEUS DAVID,67000.0,4954944.19,DEBIT
11/07/2017,Zenith POS Settlement for 11/07/2017,16100.0,4971044.19,CREDIT
11/07/2017,NEFT/INTERSWITCHNG/Goodsandservices11072,17567.26,4988611.45,CREDIT
11/07/2017,Zenith POS Settlement for 11/07/2017,22800.0,5011411.45,CREDIT
11/07/2017,DS126904/CD RUTH BABA,90000.0,5101411.45,CREDIT
11/07/2017,ISW CHARGE:ISW/135604641051/1014794871/Balance for bottles//THADDEUS DAVID,50.0,5101361.45,DEBIT
11/07/2017,Zenith POS Settlement Comm for11/07/2017,201.25,5101160.2,DEBIT
11/07/2017,Zenith POS Settlement Comm for11/07/2017,285.0,5100875.2,DEBIT
11/07/2017,ISW/135604641051/1014794871/Balance for bottles//THADDEUS DAVID,29700.0,5071175.2,DEBIT
12/07/2017,NEFT/INTERSWITCHNG/Goodsandservices12072,11910.0,5083085.2,CREDIT
12/07/2017,DS 147500 DEREK SHUAIB,358000.0,5453035.2,CREDIT
12/07/2017,ISW CHARGE:ISW/135604643409/1014794871/5bags dangote  sugar//ABDULLAHISALIHU,50.0,5452985.2,DEBIT
12/07/2017,ISW CHARGE:ISW/135604645774/1014794871/Shawarma papers//ADELEKE MICHAEL,50.0,5452935.2,DEBIT
12/07/2017,Zenith POS Settlement Comm for12/07/2017,149.38,5452785.82,DEBIT
12/07/2017,ISW/135604645774/1014794871/Shawarma papers//ADELEKE MICHAEL,60000.0,5392785.82,DEBIT
12/07/2017,ISW/135604643409/1014794871/5bags dangote  sugar//ABDULLAHISALIHU,94200.0,5298585.82,DEBIT
13/07/2017,Zenith POS Settlement for 13/07/2017,1100.0,5299685.82,CREDIT
13/07/2017,NEFT/INTERSWITCHNG/Goodsandservices13072,2779.0,5302464.82,CREDIT
13/07/2017,10300 CD / MR EMMA AWUMAL,200000.0,5502464.82,CREDIT
13/07/2017,ds 42335974 derek shuaib,225000.0,5727464.82,CREDIT
13/07/2017,Zenith POS Settlement Comm for13/07/2017,13.75,5727451.07,DEBIT
13/07/2017,ISW CHARGE:ISW/135604648137/1014794871/Busrepair//IKECHUKWU AUGUSTINEOBIDIALO,50.0,5727401.07,DEBIT
13/07/2017,ISW CHARGE:ISW/135604648149/1014794871/Thursday gas refill//VICTORIA PETERIKAN,50.0,5727351.07,DEBIT
13/07/2017,ISW CHARGE:ISW/135604648409/1014794871/Busvehicle registration//AMETSE MR S J,50.0,5727301.07,DEBIT
13/07/2017,ISW CHARGE:ISW/135604649107/1014794871/Food items bought//SUNDAY MICHIKAJOHN,50.0,5727251.07,DEBIT
13/07/2017,ISW/135604648149/1014794871/Thursday gas refill//VICTORIA PETERIKANI,36000.0,5691251.07,DEBIT
13/07/2017,ISW/135604648137/1014794871/Busrepair//IKECHUKWU AUGUSTINEOBIDIALO,57000.0,5589251.07,CREDIT
13/07/2017,ISW/135604649107/1014794871/Food items bought//SUNDAY MICHIKAJOHN,77700.0,5511551.07,DEBIT
13/07/2017,SHAWARMA LAPS OFCHICKEN//TRF TO SAYED FARMSLTD-ABUJA A/C,161880.0,5349671.07,DEBIT
14/07/2017,Zenith POS Settlement for 14/07/2017,2000.0,5351671.07,CREDIT
14/07/2017,NEFT/INTERSWITCHNG/Goodsandservices14072,3076.75,5354747.82,CREDIT
14/07/2017,28777/CD MADAM CHIGOZIE,25000.0,5379747.82,CREDIT
14/07/2017,Zenith POS Settlement Comm for14/07/2017,25.0,5379722.82,DEBIT
14/07/2017,ISW CHARGE:ISW/135604649914/1014794871/Supply of mama gold 100bags//IBRAHIMBAK,50.0,5379672.82,DEBIT
14/07/2017,ISW CHARGE:ISW/135604649980/1014794871/Suya local chicken//BARAU GAZALI,50.0,5379622.82,DEBIT
14/07/2017,STAMP DUTY CHARGE,900.0,5378722.82,DEBIT
14/07/2017,ISW/135604649980/1014794871/Suya local chicken//BARAU GAZALI,42500.0,5336222.82,DEBIT
14/07/2017,STK BUTTER AND OTHERS//TRFTO  EV MIRACLE BAKERSCOMPANY NIG LTD,103800.0,5232422.82,DEBIT
14/07/2017,ISW/135604649914/1014794871/Supply of mama gold 100bags//IBRAHIMBAKO,1120000.0,4112422.82,CREDIT
16/07/2017,15 CRATES OF EGGS//TRF TOOFOR U UKPABI,12750.0,4099672.82,DEBIT
17/07/2017,NEFT/INTERSWITCHNG/Goodsandservices15072,3176.0,4102848.82,CREDIT
17/07/2017,NEFT/INTERSWITCHNG/Goodsandservices17072,8734.0,4111582.82,CREDIT
17/07/2017,NEFT/INTERSWITCHNG/Goodsandservices16072,8932.5,4120515.32,CREDIT
17/07/2017,Zenith POS Settlement for 17/07/2017,16100.0,4136615.32,CREDIT
17/07/2017,ds 15723 drek shuaib,333000.0,4469615.32,CREDIT
17/07/2017,ISW CHARGE:ISW/135604666386/1014794871/Balance for shawarma papers//ADELEKEMIC,50.0,4969565.32,CREDIT
17/07/2017,Zenith POS Settlement Comm for17/07/2017,201.25,4969364.07,DEBIT
17/07/2017,ISW/135604666386/1014794871/Balance for shawarma papers//ADELEKEMICHAEL,30000.0,4939364.07,DEBIT
18/07/2017,NEFT/INTERSWITCHNG/Goodsandservices18072,4565.5,4943929.57,CREDIT
18/07/2017,Zenith POS Settlement for 18/07/2017,6400.0,4950329.57,CREDIT
18/07/2017,Zenith POS Settlement Comm for18/07/2017,80.0,4950249.57,DEBIT
19/07/2017,Zenith POS Settlement for 19/07/2017,3300.0,4953549.57,CREDIT
19/07/2017,NEFT/INTERSWITCHNG/Goodsandservices19072,8237.75,4961787.32,CREDIT
19/07/2017,"NIP/GTB/LABURTA  DAVIDJAMES/NIP FROM LABURTA, DAVIDJAMES TO WOW BAKERYCONFECT",14000.0,4975787.32,CREDIT
19/07/2017,ds 80332 derek shuaib,383500.0,5359287.32,CREDIT
19/07/2017,Zenith POS Settlement Comm for19/07/2017,41.25,5359246.07,DEBIT
19/07/2017,ISW CHARGE:ISW/135604672248/1014794871/Repairs for bakery//IBE GODWINNWACHUKWU,50.0,5359196.07,DEBIT
19/07/2017,ISW/135604672248/1014794871/Repairs for bakery//IBE GODWINNWACHUKWU,20000.0,5339196.07,DEBIT
20/07/2017,NEFT/INTERSWITCHNG/Goodsandservices20072,4367.0,5343563.07,CREDIT
20/07/2017,Zenith POS Settlement for 20/07/2017,4400.0,5347963.07,CREDIT
20/07/2017,ds 16633 dep pius ishaku,115000.0,5462963.07,CREDIT
20/07/2017,cd/ emmy awunah /8524,180000.0,5642963.07,CREDIT
20/07/2017,DS 1583659 DEREK SHUAIB,215000.0,5857963.07,CREDIT
20/07/2017,Zenith POS Settlement Comm for20/07/2017,55.0,5857908.07,DEBIT
21/07/2017,NIP/DBP/JAKONDA  ADAILILAYWI/NIP - TRF IFO WOW BAKERYCONFECTIONERY AND PASTRI,13000.0,5877557.82,CREDIT
21/07/2017,DS 4219069 DEREK SHUAIB,320000.0,6197557.82,CREDIT
21/07/2017,ISW CHARGE:ISW/135604677818/1014794871/Services for filing//A.Y. USMANCONSULTI,50.0,6197507.82,DEBIT
21/07/2017,"ISW CHARGE:ISW/135604677870/1014794871/Golfrepairs//SULEIMAN, HAMZA",50.0,6197457.82,DEBIT
21/07/2017,ISW CHARGE:ISW/135604678327/1014794871/Gashead and refil//VICTORIA PETERIKANI,50.0,6197407.82,DEBIT
21/07/2017,STAMP DUTY CHARGE,1000.0,6196407.82,DEBIT
21/07/2017,"ISW/135604677870/1014794871/Golfrepairs//SULEIMAN, HAMZA",12500.0,6183907.82,DEBIT
21/07/2017,ISW/135604677818/1014794871/Services for filing//A.Y. USMANCONSULTING LIMITED,20000.0,6163907.82,DEBIT
21/07/2017,ISW/135604678327/1014794871/Gashead and refil//VICTORIA PETERIKANI,48000.0,6115907.82,DEBIT
23/07/2017,ISW CHARGE:ISW/135604680800/1014794871/Service charge balance//ZECHARIAHJOSEPH,50.0,6115857.82,DEBIT
23/07/2017,ISW CHARGE:ISW/135604681931/1014794871/Habib and fura//SOLOMON BABA,50.0,6115807.82,DEBIT
23/07/2017,ISW CHARGE:ISW/135604681936/1014794871/15crates on Saturday//SWIFT PLUSFARMS,50.0,6115757.82,DEBIT
23/07/2017,ISW/135604681936/1014794871/15crates on Saturday//SWIFT PLUSFARMS PRODUCE LIMI,12450.0,6103307.82,DEBIT
23/07/2017,FOR WORK DONE//TRF TO MOSESALABI,25000.0,6078307.82,DEBIT
23/07/2017,ISW/135604680800/1014794871/Service charge balance//ZECHARIAHJOSEPH THLAWUSON,100000.0,5885307.82,CREDIT
23/07/2017,LAPS OF CHICKEN 7SACKS//TRFTO SAYED FARMS LTD-ABUJA A/C,174360.0,5710947.82,DEBIT
24/07/2017,NEFT/INTERSWITCHNG/Goodsandservices24072,5061.75,5716009.57,CREDIT
24/07/2017,NEFT/INTERSWITCHNG/Goodsandservices22072,7344.5,5723354.07,CREDIT
24/07/2017,Zenith POS Settlement for 24/07/2017,9200.0,5732554.07,CREDIT
24/07/2017,NEFT/INTERSWITCHNG/Goodsandservices23072,15880.0,5748434.07,CREDIT
24/07/2017,ds 438818 derek shaiub,183000.0,5931434.07,CREDIT
24/07/2017,DS146008/CD RUTH BABA,491250.0,6422684.07,CREDIT
24/07/2017,ISW CHARGE:ISW/135604684032/1014794871/Mama gold supplied//IBRAHIM BAKO,50.0,6422634.07,DEBIT
24/07/2017,ISW CHARGE:ISW/135604684037/1014794871/Two50kg cylinders//VICTORIA PETERIKANI,50.0,6422584.07,DEBIT
24/07/2017,Zenith POS Settlement Comm for24/07/2017,115.0,6422469.07,DEBIT
24/07/2017,ISW/135604684037/1014794871/Two50kg cylinders//VICTORIA PETERIKANI,32000.0,6390469.07,DEBIT
24/07/2017,ISW/135604684032/1014794871/Mama gold supplied//IBRAHIM BAKO,1000000.0,5390469.07,DEBIT
25/07/2017,NEFT/INTERSWITCHNG/Goodsandservices25072,1091.75,5391560.82,CREDIT
25/07/2017,Zenith POS Settlement for 25/07/2017,4400.0,5395960.82,CREDIT
25/07/2017,ds 400198 derek shuaib,235000.0,5630960.82,CREDIT
25/07/2017,Zenith POS Settlement Comm for25/07/2017,55.0,5630905.82,DEBIT
25/07/2017,MILK OIL//TRF TO EMMANUELADEGOJU,120000.0,5510905.82,DEBIT
26/07/2017,NEFT/INTERSWITCHNG/Goodsandservices26072,992.5,5511898.32,CREDIT
26/07/2017,Zenith POS Settlement for 26/07/2017,2200.0,5514098.32,CREDIT
26/07/2017,ds 416787 derek shuaib,350500.0,5864598.32,CREDIT
26/07/2017,ISW CHARGE:ISW/135604689911/1014794871/Bread and snacks nylon//APEXPACKAGING L,50.0,5864520.82,CREDIT
26/07/2017,ISW CHARGE:ISW/135604691322/1014794871/Cameras//OGAR CLEMENT OGABOR,50.0,5864470.82,DEBIT
26/07/2017,ISW/135604691322/1014794871/Cameras//OGAR CLEMENT OGABOR,43000.0,5821470.82,DEBIT
26/07/2017,ISW/135604689911/1014794871/Bread and snacks nylon//APEXPACKAGING LIMITED,100000.0,5721470.82,DEBIT
27/07/2017,NEFT/INTERSWITCHNG/Goodsandservices27072,6749.0,5728219.82,CREDIT
27/07/2017,ds 401810 derek shuiab,267000.0,5995219.82,CREDIT
28/07/2017,NEFT/INTERSWITCHNG/Goodsandservices28072,3870.75,5999090.57,CREDIT
28/07/2017,Zenith POS Settlement for 28/07/2017,5900.0,6004990.57,CREDIT
28/07/2017,Zenith POS Settlement for 28/07/2017,8500.0,6013490.57,CREDIT
28/07/2017,CD/DEREK S/DS420740,293000.0,6306490.57,CREDIT
28/07/2017,ISW CHARGE:ISW/135604697342/1014794871/Balance flour mamagold//IBRAHIM  BAKO,50.0,6306440.57,DEBIT
28/07/2017,ISW CHARGE:ISW/135604697360/1014794871/Balance for mould//THADDEUS DAVID,50.0,6306390.57,DEBIT
28/07/2017,Zenith POS Settlement Comm for28/07/2017,73.75,6306316.82,DEBIT
28/07/2017,Zenith POS Settlement Comm for28/07/2017,106.25,6306210.57,DEBIT
28/07/2017,SMS Notification Charge Jul 2017,556.0,6305654.57,DEBIT
28/07/2017,STAMP DUTY CHARGE,850.0,6304804.57,DEBIT
28/07/2017,ISW/135604697360/1014794871/Balance for mould//THADDEUS DAVID,50000.0,6254804.57,DEBIT
28/07/2017,ISW/135604697342/1014794871/Balance flour mamagold//IBRAHIM  BAKO,725000.0,5529804.57,DEBIT
30/07/2017,"ISW/135604701981/1014794871/5cartons//ALAGBE, SAMSONBABATUNDE",47500.0,5482254.57,CREDIT
31/07/2017,Rvsl:ISW CHARGE:ISW/135604703868/1014794871/Refillfor last week and today//VIC,50.0,5482304.57,CREDIT
31/07/2017,NEFT/INTERSWITCHNG/Goodsandservices31072,14391.27,5496695.84,CREDIT
31/07/2017,NEFT/INTERSWITCHNG/Goodsandservices30072,18857.52,5515553.36,CREDIT
31/07/2017,NEFT/INTERSWITCHNG/Goodsandservices29072,26152.4,5541705.76,CREDIT
31/07/2017,Rvsl:ISW/135604703868/1014794871/Refill for last week andtoday//VICTORIA PETER,40000.0,5581705.76,CREDIT
31/07/2017,Zenith POS Settlement for 31/07/2017,84450.0,5666155.76,CREDIT
31/07/2017,DS 478064 DEREK S,241500.0,5907655.76,CREDIT
31/07/2017,DS353425/CD=RUTH BABA,715270.0,6622925.76,CREDIT
31/07/2017,ISW CHARGE:ISW/135604703868/1014794871/Refillfor last week and today//VICTORIA,50.0,6622875.76,DEBIT
31/07/2017,Zenith POS Settlement Comm for31/07/2017,1055.72,6621820.04,DEBIT
31/07/2017,Acct Maint. Fee + VAT,9023.6,6612796.44,DEBIT
31/07/2017,ISW/135604703868/1014794871/Refillfor last week and today//VICTORIAPETER IKANI,40000.0,6572796.44,DEBIT
01/08/2017,Rvsl:ISW CHARGE:ISW/135604707936/1014794871/Gasrefill last week and yesterday/,50.0,6572846.44,CREDIT
01/08/2017,Zenith POS Settlement for 01/08/2017,3550.0,6576396.44,CREDIT
01/08/2017,NEFT/INTERSWITCHNG/Goodsandservices01082,4317.38,6580713.82,CREDIT
01/08/2017,Rvsl:ISW/135604707936/1014794871/Gas refill last week andyesterday//VICTORIA PE,40000.0,6620713.82,CREDIT
01/08/2017,ds 3966560 derek s,173500.0,6794213.82,CREDIT
01/08/2017,Zenith POS Settlement Comm for01/08/2017,44.38,6794169.44,DEBIT
01/08/2017,ISW CHARGE:ISW/135604708079/1014794871/Carrier bags for items purchased//APEX P,50.0,6794069.44,CREDIT
01/08/2017,ISW/135604707936/1014794871/Gasrefill last week andyesterday//VICTORIA PETER I,40000.0,6754069.44,DEBIT
01/08/2017,ISW/135604708079/1014794871/Carrier bags for items purchased//APEXPACKAGING LIM,100000.0,6654069.44,DEBIT
02/08/2017,NIP/DBP/JAKONDA  ADAILILAYWI/NIP - TRF IFO WOW BAKERYCONFECTIONERY AND PASTRI,14500.0,6668569.44,CREDIT
02/08/2017,Zenith POS Settlement for 02/08/2017,40850.0,6709419.44,CREDIT
02/08/2017,NEFT/INTERSWITCHNG/Goodsandservices02082,51858.14,6761277.58,CREDIT
02/08/2017,ds 455415 derek shuab,335000.0,7096277.58,CREDIT
02/08/2017,ISW CHARGE:ISW/135604713106/1014794871/150bags of flour mamagold//IBRAHIMBAKO,50.0,7096227.58,DEBIT
02/08/2017,ISW CHARGE:ISW/135604713116/1014794871/Julypayment//KALU .L. CHIKA,50.0,7096177.58,DEBIT
02/08/2017,Zenith POS Settlement Comm for02/08/2017,456.27,7095721.31,CREDIT
02/08/2017,ISW/135604713116/1014794871/Julypayment//KALU .L. CHIKA,40000.0,7055721.31,DEBIT
02/08/2017,LAPS FOR SHAWARMA//TRF TOSAYED FARMS LTD-ABUJA A/C,177240.0,6878481.31,DEBIT
02/08/2017,ISW/135604713106/1014794871/150bags of flour mamagold//IBRAHIMBAKO,1725000.0,5153481.31,DEBIT
03/08/2017,Zenith POS Settlement for 03/08/2017,11700.0,5165181.31,CREDIT
03/08/2017,NEFT/INTERSWITCHNG/Goodsandservices03082,15880.02,5181061.33,CREDIT
03/08/2017,ds 396177 derek shuaibu,495000.0,5676061.33,CREDIT
03/08/2017,ISW CHARGE:ISW/135604715412/1014794871/2cameras//OGAR CLEMENT OGABOR,50.0,5676011.33,DEBIT
03/08/2017,Zenith POS Settlement Comm for03/08/2017,146.27,5675865.06,CREDIT
03/08/2017,BUTTER FOR BAKING//TRF TO    EVMIRACLE BAKERS COMPANY NIGLTD,99000.0,5533865.06,CREDIT
04/08/2017,Zenith POS Settlement for 04/08/2017,17350.0,5551215.06,CREDIT
04/08/2017,NEFT/INTERSWITCHNG/Goodsandservices04082,22083.15,5573298.21,CREDIT
04/08/2017,DS 442540 DEREK SHUAIB,240500.0,5813798.21,CREDIT
04/08/2017,Zenith POS Settlement Comm for04/08/2017,206.89,5813591.32,DEBIT
04/08/2017,STAMP DUTY CHARGE,950.0,5812641.32,DEBIT
04/08/2017,MIX FOR ICE CREAM//TRF TOISAAC G NKEMDILIM,64000.0,5748641.32,DEBIT
06/08/2017,ISW CHARGE:ISW/135604724403/1014794871/Repairs at bakery//IBE GODWINNWACHUKWU,50.0,5748591.32,DEBIT
06/08/2017,ISW/135604724403/1014794871/Repairs at bakery//IBE GODWINNWACHUKWU,30000.0,5718591.32,DEBIT
07/08/2017,NEFT/INTERSWITCHNG/Goodsandservices06082,3176.0,5721767.32,CREDIT
07/08/2017,NEFT/INTERSWITCHNG/Goodsandservices07082,4664.75,5726432.07,CREDIT
07/08/2017,NEFT/INTERSWITCHNG/Goodsandservices05082,12257.38,5738689.45,CREDIT
07/08/2017,Zenith POS Settlement for 07/08/2017,24500.0,5763189.45,CREDIT
07/08/2017,CD  PIUS ISHAKU/  479841,116020.0,5879209.45,CREDIT
07/08/2017,ds 442371 derek shuaib,552000.0,6431209.45,CREDIT
07/08/2017,Zenith POS Settlement Comm for07/08/2017,306.25,6430903.2,DEBIT
08/08/2017,NEFT/INTERSWITCHNG/Goodsandservices08082,4168.5,6435071.7,CREDIT
08/08/2017,Zenith POS Settlement for 08/08/2017,5200.0,6440271.7,CREDIT
08/08/2017,CD/DEREK S/DS77207,197000.0,6637271.7,CREDIT
08/08/2017,ISW CHARGE:ISW/135604730568/1014794871/Sweetner and other items//ODOR FIDELISC,50.0,6637221.7,DEBIT
08/08/2017,EMILY AND MOORE//TRF TO    EVMIRACLE BAKERS COMPANY NIGLTD,135500.0,6501656.7,CREDIT
08/08/2017,PREMIX//TRF TO    RICHY BAKING& ACCESSORIES LIMITED,335000.0,6166656.7,DEBIT
08/08/2017,ISW/135604730568/1014794871/Sweetner and other items//ODOR FIDELISCHUKWUEMEKA,441700.0,5724956.7,DEBIT
09/08/2017,NEFT/INTERSWITCHNG/Goodsandservices09082,4367.0,5729323.7,CREDIT
09/08/2017,Zenith POS Settlement for 09/08/2017,5400.0,5734723.7,CREDIT
09/08/2017,DS325541/CD RUTH BABA,100000.0,5834723.7,CREDIT
09/08/2017,CD/DEREK S/DS77259,359000.0,6193723.7,CREDIT
09/08/2017,Zenith POS Settlement Comm for09/08/2017,67.5,6193656.2,DEBIT
10/08/2017,NEFT/INTERSWITCHNG/Goodsandservices10082,4664.75,6198320.95,CREDIT
10/08/2017,Zenith POS Settlement for 10/08/2017,9800.0,6208120.95,CREDIT
10/08/2017,DS344233/CD PIUS ISHAKU,100000.0,6308120.95,CREDIT
10/08/2017,CD/DEREK S/DS4216912,216000.0,6524120.95,CREDIT
10/08/2017,Zenith POS Settlement Comm for10/08/2017,122.5,6523998.45,DEBIT
11/08/2017,RVSL MC POS COMM170801140845 010817,50.0,6524048.45,CREDIT
11/08/2017,Zenith POS Settlement for 11/08/2017,5500.0,6529548.45,CREDIT
11/08/2017,"NIP/GTB/AJAYI  OBAFEMIOLANREWAJU/NIP FROM AJAYI,OBAFEMI OLANREWAJU TO WOWBAKE",8000.0,6537548.45,CREDIT
11/08/2017,NEFT/INTERSWITCHNG/Goodsandservices11082,9031.75,6546580.2,CREDIT
11/08/2017,CD/DEREK S/DS0988888,250000.0,6796580.2,CREDIT
11/08/2017,ISW CHARGE:ISW/135604739497/1014794871/Purchases on the 8th//SUNDAY MICHIKAJOH,50.0,6796530.2,DEBIT
11/08/2017,Zenith POS Settlement Comm for11/08/2017,68.75,6796461.45,DEBIT
11/08/2017,STAMP DUTY CHARGE,1050.0,6795411.45,DEBIT
11/08/2017,ISW/135604739497/1014794871/Purchases on the 8th//SUNDAY MICHIKAJOHN,158800.0,6632611.45,CREDIT
13/08/2017,"ISW CHARGE:ISW/135604743456/1014794871/350kg, 4 12.5kg//VICTORIA PETERIKANI",50.0,6632561.45,DEBIT
13/08/2017,"ISW/135604743456/1014794871/350kg, 4 12.5kg//VICTORIA PETERIKANI",64000.0,6568561.45,DEBIT
13/08/2017,12TH AUGUST LAPS SUPPLY//TRFTO SAYED FARMS LTD-ABUJA A/C,164400.0,6404161.45,DEBIT
14/08/2017,NEFT/INTERSWITCHNG/Goodsandservices14082,3473.75,6407635.2,CREDIT
14/08/2017,Zenith POS Settlement for 14/08/2017,5600.0,6413235.2,CREDIT
14/08/2017,NEFT/INTERSWITCHNG/Goodsandservices13082,9031.75,6422266.95,CREDIT
14/08/2017,NEFT/INTERSWITCHNG/Goodsandservices12082,15582.25,6437849.2,CREDIT
14/08/2017,CD  PIUS ISHAKU/  3923641,100000.0,6537849.2,CREDIT
14/08/2017,cd/derek s/ds0948035,538000.0,7075849.2,CREDIT
14/08/2017,Zenith POS Settlement Comm for14/08/2017,70.0,7075779.2,DEBIT
15/08/2017,Zenith POS Settlement for 15/08/2017,9450.0,7085229.2,CREDIT
15/08/2017,NEFT/INTERSWITCHNG/Goodsandservices15082,10818.25,7096047.45,CREDIT
15/08/2017,CD/DEREK S/DS1572074,395600.0,7491647.45,CREDIT
15/08/2017,ISW CHARGE:ISW/135604750540/1014794871/Tiles//ODINAKA ARONU,50.0,7491597.45,DEBIT
15/08/2017,ISW CHARGE:ISW/135604750821/1014794871/60bags of flour//IBRAHIM  BAKO,50.0,7491547.45,DEBIT
15/08/2017,Zenith POS Settlement Comm for15/08/2017,118.13,7491429.32,DEBIT
15/08/2017,ISW/135604750540/1014794871/Tiles//ODINAKA ARONU,70000.0,7421429.32,DEBIT
15/08/2017,ISW/135604750821/1014794871/60bags of flour//IBRAHIM  BAKO,690000.0,6731429.32,DEBIT
16/08/2017,Zenith POS Settlement for 16/08/2017,3100.0,6734529.32,CREDIT
16/08/2017,NIP/FBN/ALADESANMI ADEYINKAFRANCIS/FBNMOBILE:WOWBAKERY CONFECTIONERY ANDPASTR,8800.0,6747299.32,CREDIT
16/08/2017,CD  PIUS ISHAKU/  1590049,22320.0,6769619.32,CREDIT
16/08/2017,CD/HABIB M/DS4236254,245500.0,7015119.32,CREDIT
16/08/2017,Zenith POS Settlement Comm for16/08/2017,38.75,7015080.57,DEBIT
16/08/2017,ISW CHARGE:ISW/135604753445/1014794871/Walltiles//HUMPHREY IFEDIUZOCHUKWU,50.0,7015030.57,DEBIT
16/08/2017,"ISW CHARGE:ISW/135604753729/1014794871/Payment//CHRISTOPHER, VICTORYOLUWATOMI",50.0,7014980.57,DEBIT
16/08/2017,"ISW/135604753729/1014794871/Payment//CHRISTOPHER, VICTORYOLUWATOMI",9900.0,7005080.57,DEBIT
16/08/2017,ISW/135604753445/1014794871/Walltiles//HUMPHREY IFEDIUZOCHUKWU,90500.0,6914580.57,DEBIT
17/08/2017,Zenith POS Settlement for 17/08/2017,500.0,6915080.57,CREDIT
17/08/2017,NEFT/INTERSWITCHNG/Goodsandservices17082,14192.75,6929273.32,CREDIT
17/08/2017,TRF FRM ANAYOCHI   AMACHREETO WOW BAKERYCONFECTIONERY AND PASTRIESNI,15000.0,6944273.32,CREDIT
17/08/2017,CD/HABIB M/DS802837,252000.0,7196273.32,CREDIT
17/08/2017,Zenith POS Settlement Comm for17/08/2017,6.25,7196267.07,DEBIT
17/08/2017,PURCHASE OF ITEMS//TRF TOEUGINE CHIKA AZEGBA,110000.0,7086267.07,DEBIT
18/08/2017,Zenith POS Settlement for 18/08/2017,2200.0,7088467.07,CREDIT
18/08/2017,NEFT/INTERSWITCHNG/Goodsandservices18082,4466.25,7092933.32,CREDIT
18/08/2017,CD/DAREK S/DS2207133,345500.0,7438433.32,CREDIT
18/08/2017,Zenith POS Settlement Comm for18/08/2017,27.5,7438405.82,DEBIT
20/08/2017,ISW CHARGE:ISW/135604760124/1014794871/Printing//CHARLES  IHEDIOHA,50.0,7437355.82,CREDIT
20/08/2017,ISW/135604760124/1014794871/Printing//CHARLES  IHEDIOHA,247000.0,7190355.82,DEBIT
21/08/2017,NEFT/INTERSWITCHNG/Goodsandservices19082,7940.0,7198295.82,CREDIT
21/08/2017,NEFT/INTERSWITCHNG/Goodsandservices21082,8138.5,7206434.32,CREDIT
21/08/2017,NEFT/INTERSWITCHNG/Goodsandservices20082,8634.75,7215069.07,CREDIT
21/08/2017,Zenith POS Settlement for 21/08/2017,14450.0,7229519.07,CREDIT
21/08/2017,DS 3910538/CD/ DEREK S,528000.0,7757519.07,CREDIT
21/08/2017,ISW CHARGE:ISW/135604764449/1014794871/Customer nylon for wow//APEXPACKAGING L,50.0,7757469.07,DEBIT
21/08/2017,ISW CHARGE:ISW/135604764460/1014794871/Genservice//IHEANACHO ANTHONYEWUZIE,50.0,7757419.07,DEBIT
21/08/2017,ISW CHARGE:ISW/135604765479/1014794871/Partpayment for flour//IBRAHIM  BAKO,50.0,7757369.07,DEBIT
21/08/2017,Zenith POS Settlement Comm for21/08/2017,180.63,7757188.44,DEBIT
21/08/2017,ISW/135604764460/1014794871/Genservice//IHEANACHO ANTHONYEWUZIE,18000.0,7739188.44,DEBIT
21/08/2017,ISW/135604764449/1014794871/Customer nylon for wow//APEXPACKAGING LIMITED,24600.0,7714588.44,DEBIT
21/08/2017,CHANGE//TRF TO ADAEZE PEACEANTHONY-IDOKO,40000.0,7674588.44,DEBIT
21/08/2017,6 BUCKETS MOORE BUTTER//TRFTO    EV MIRACLE BAKERSCOMPANY NIG LTD,55200.0,7619388.44,DEBIT
21/08/2017,ISW/135604765479/1014794871/Partpayment for flour//IBRAHIM  BAKO,1000000.0,6619388.44,DEBIT
22/08/2017,Zenith POS Settlement for 22/08/2017,2200.0,6621588.44,CREDIT
22/08/2017,NEFT/INTERSWITCHNG/Goodsandservices22082,11314.5,6632902.94,CREDIT
22/08/2017,DS307883/CD RUHT BABA,450500.0,7383402.94,CREDIT
22/08/2017,Zenith POS Settlement Comm for22/08/2017,27.5,7383375.44,DEBIT
22/08/2017,ISW CHARGE:ISW/135604768857/1014794871/Another part payment//IBRAHIM  BAKO,50.0,7383325.44,DEBIT
22/08/2017,ISW CHARGE:ISW/135604768859/1014794871/Forketchup and others//SUNDAYMICHIKA J,50.0,7383275.44,DEBIT
22/08/2017,"ISW CHARGE:ISW/135604768864/1014794871/ACmaintanance//THOMAS, GODWIN",50.0,7383225.44,DEBIT
22/08/2017,"ISW/135604768864/1014794871/ACmaintanance//THOMAS, GODWIN",17000.0,7366225.44,DEBIT
22/08/2017,4 CARTONS ICING SUGAR//TRF TOEV MIRACLE BAKERS COMPANYNIG LTD,46000.0,7320225.44,DEBIT
22/08/2017,ISW/135604768859/1014794871/Forketchup and others//SUNDAYMICHIKA JOHN,120600.0,7199625.44,DEBIT
22/08/2017,ISW/135604768857/1014794871/Another part payment//IBRAHIM  BAKO,1000000.0,6199625.44,DEBIT
23/08/2017,Zenith POS Settlement for 23/08/2017,2200.0,6201825.44,CREDIT
23/08/2017,NEFT/INTERSWITCHNG/Goodsandservices23082,9925.0,6211750.44,CREDIT
23/08/2017,CD/HABIB M/DS4238316,166000.0,6377750.44,CREDIT
23/08/2017,Zenith POS Settlement Comm for23/08/2017,27.5,6377722.94,DEBIT
23/08/2017,RV Loc POS 539983xxxx3343 220817,3800.0,6373922.94,DEBIT
23/08/2017,CHOCOLATE AND STRAWBERRYPOWDER//TRF TO ISAAC GNKEMDILIM,64000.0,6309922.94,DEBIT
24/08/2017,Zenith POS Settlement for 24/08/2017,4300.0,6314222.94,CREDIT
24/08/2017,NEFT/INTERSWITCHNG/Goodsandservices24082,8337.0,6322559.94,CREDIT
24/08/2017,CD/HABIB M/DS141056,168500.0,6491059.94,CREDIT
24/08/2017,Zenith POS Settlement Comm for24/08/2017,53.75,6490956.19,CREDIT
24/08/2017,ISW/135604772481/1014794871/Video coverage//TSADO JOSHUAALHASSAN,35000.0,6455956.19,DEBIT
24/08/2017,7 SACKS ON 24TH AUGUST//TRFTO SAYED FARMS LTD-ABUJA A/C,166800.0,6289156.19,DEBIT
25/08/2017,Zenith POS Settlement for 25/08/2017,3300.0,6292456.19,CREDIT
25/08/2017,NEFT/INTERSWITCHNG/Goodsandservices25082,7245.25,6299701.44,CREDIT
25/08/2017,frm sarah to wow bakery,20000.0,6319701.44,CREDIT
25/08/2017,Zenith POS Settlement Comm for25/08/2017,41.25,6319660.19,DEBIT
25/08/2017,SMS Notification Charge Aug 2017,436.0,6319224.19,DEBIT
25/08/2017,STAMP DUTY CHARGE,900.0,6318324.19,DEBIT
27/08/2017,Rvsl:ISW CHARGE:ISW/135604780411/1014794871/Refillfor 6small and 2big//VICTORI,50.0,6318374.19,CREDIT
27/08/2017,Rvsl:ISW/135604780411/1014794871/Refill for 6small and 2big//VICTORIAPETER IKAN,56000.0,6374374.19,CREDIT
27/08/2017,ISW CHARGE:ISW/135604780411/1014794871/Refillfor 6small and 2big//VICTORIA PET,50.0,6374324.19,DEBIT
27/08/2017,ISW/135604780411/1014794871/Refillfor 6small and 2big//VICTORIAPETER IKANI,56000.0,6318324.19,DEBIT
28/08/2017,DS321117/CD PIUS ISHAKU,220020.0,6538344.19,CREDIT
28/08/2017,WOOD FOR RENOVATION//TRF TOMOSES ALABI,300000.0,6238344.19,DEBIT
28/08/2017,PAYMENT FOR YOGURT MIX//TRFTO CHUKWUDI DARLINGTONJIDEOFO,549000.0,5689344.19,DEBIT
29/08/2017,cd/dereck sghub/ds603345,329500.0,6018844.19,CREDIT
29/08/2017,ISW CHARGE:ISW/135604787279/1014794871/Slab//TOSAM KREATIONS LTD,50.0,6018794.19,DEBIT
29/08/2017,DRINKS FOR SHOP//TRF TORHODA FUNMILAYO AMINU,81500.0,5937294.19,DEBIT
29/08/2017,ISW/135604787279/1014794871/Slab//TOSAM KREATIONS LTD,200000.0,5737294.19,DEBIT
30/08/2017,ISW CHARGE:ISW/135604792147/1014794871/Service agreement pay//HONVOHCLAUDE PIE,50.0,6002744.19,CREDIT
30/08/2017,ISW/135604792147/1014794871/Service agreement pay//HONVOHCLAUDE PIERRE,500000.0,5502744.19,DEBIT
31/08/2017,CD/HABIB M/DS152670,55000.0,5557744.19,CREDIT
31/08/2017,CD/HABIB M/DS152667,224500.0,5782244.19,CREDIT
31/08/2017,ISW CHARGE:ISW/135604794172/1014794871/Balance for slab//TOSAM KREATIONSLTD,50.0,5782194.19,DEBIT
31/08/2017,ISW CHARGE:ISW/135604796358/1014794871/Forglass//KENNETH CHIBUZO OFFOR,50.0,5782144.19,DEBIT
31/08/2017,Acct Maint. Fee + VAT,10060.06,5772084.13,CREDIT
31/08/2017,ISW/135604794172/1014794871/Balance for slab//TOSAM KREATIONSLTD,40000.0,5732084.13,DEBIT
31/08/2017,ISW/135604796358/1014794871/Forglass//KENNETH CHIBUZO OFFOR,100000.0,5632084.13,DEBIT
31/08/2017,LAPS FOR CHICKEN ON 31ST//TRFTO SAYED FARMS LTD-ABUJA A/C,129000.0,5503084.13,DEBIT
31/08/2017,WOODEN TILES//TRF TOHUMPHREY   UZOCHUKWU,200000.0,5303084.13,DEBIT
01/09/2017,NIP/FBN/ODO CALEBOZIOMA/FBNMOBILE:WOWBAKERY CONFECTIONERY ANDPASTRIES NI,1100.0,5304184.13,CREDIT
01/09/2017,STAMP DUTY CHARGE,300.0,5303884.13,DEBIT
01/09/2017,BALANCE FOR WOOD//TRF TOMOSES ALABI,170000.0,5133884.13,DEBIT
01/09/2017,EMILY AND STK 1ST SEPT//TRF TOEV MIRACLE BAKERS COMPANYNIG LTD,209000.0,4924884.13,DEBIT
03/09/2017,ISW CHARGE:ISW/135604801530/1014794871/Cleaning//WILLIAMS NELSON UDUAK,50.0,4924834.13,DEBIT
03/09/2017,MR MOSES//TRF TO MOSES ALABI,40000.0,4884834.13,DEBIT
03/09/2017,ISW/135604801530/1014794871/Cleaning//WILLIAMS NELSON UDUAK,50000.0,4794834.13,CREDIT
04/09/2017,ISW CHARGE:ISW/135604802491/1014794871/Balance payment for flour//IBRAHIMBAKO,50.0,4794784.13,DEBIT
04/09/2017,PURCHASE OF WOOD//TRF TOMOSES ALABI,70000.0,4724784.13,DEBIT
04/09/2017,ISW/135604802491/1014794871/Balance payment for flour//IBRAHIMBAKO,1450000.0,3274784.13,DEBIT
05/09/2017,CD/DEREK S/DS4240420,638550.0,3913334.13,CREDIT
05/09/2017,DS270524/CD PIUS ISHAKU,640000.0,4553334.13,CREDIT
05/09/2017,BIG FOIL PLATES//TRF TO OGECHICHINONSO MADU,18000.0,4535334.13,DEBIT
06/09/2017,CD/HABIB M/DS3907719,385500.0,4920834.13,CREDIT
06/09/2017,ISW CHARGE:ISW/135604868665/1014794871/Flour supplied last week//AKINOLAGBEMIS,50.0,4920784.13,DEBIT
06/09/2017,ISW/135604868665/1014794871/Flour supplied last week//AKINOLAGBEMISOLA SULIAT,1356000.0,3564784.13,DEBIT
07/09/2017,ds3929066/cd/habib mary,377020.0,3941804.13,CREDIT
07/09/2017,INSTANT SUCCESS YEAST//TRF TOEV MIRACLE BAKERS COMPANYNIG LTD,273000.0,3668804.13,DEBIT
08/09/2017,Rvsl:ISW CHARGE:ISW/135604875602/1014794871/Banner for wow//OMONIYI OLUWASOGOA,50.0,3668854.13,CREDIT
08/09/2017,Rvsl:ISW CHARGE:ISW/135604876348/1014794871/Wowbanner//OLUWASEUN AKOSILE,50.0,3668904.13,CREDIT
08/09/2017,TRF FRM OLANREWAJU BENSONAMUDA TO WOW BAKERYCONFECTIONERY AND PASTRIESNI,6000.0,3674904.13,CREDIT
08/09/2017,Rvsl:ISW/135604875602/1014794871/Banner for wow//OMONIYIOLUWASOGO ADEWALE,60000.0,3734904.13,CREDIT
08/09/2017,ISW CHARGE:ISW/135604875602/1014794871/Banner for wow//OMONIYI OLUWASOGOADEWAL,50.0,3794854.13,CREDIT
08/09/2017,ISW CHARGE:ISW/135604876348/1014794871/Wowbanner//OLUWASEUN AKOSILE,50.0,3794804.13,DEBIT
08/09/2017,STAMP DUTY CHARGE,250.0,3794554.13,DEBIT
08/09/2017,ISW/135604875602/1014794871/Banner for wow//OMONIYI OLUWASOGOADEWALE,60000.0,3734554.13,DEBIT
08/09/2017,ISW/135604876348/1014794871/Wowbanner//OLUWASEUN AKOSILE,60000.0,3674554.13,DEBIT
10/09/2017,Adesunloro,2200.0,3676754.13,CREDIT
10/09/2017,BALANCE FOR TILES//TRF TOHUMPHREY   UZOCHUKWU,50000.0,3626754.13,DEBIT
11/09/2017,NEFT/INTERSWITCHNG/Goodsandservices09092,11165.63,3637919.76,CREDIT
11/09/2017,NEFT/INTERSWITCHNG/Goodsandservices10092,14986.76,3652906.52,CREDIT
11/09/2017,ds161814/cd baba ruth,222000.0,3874906.52,CREDIT
11/09/2017,ds1441462/cd/derek shuaib,715000.0,4589906.52,CREDIT
11/09/2017,ISW CHARGE:ISW/135604882854/1014794871/Refillfor friday and today//VICTORIA PE,50.0,4589856.52,DEBIT
11/09/2017,ISW/135604882854/1014794871/Refillfor friday and today//VICTORIAPETER IKANI,60000.0,4529856.52,DEBIT
12/09/2017,NEFT/INTERSWITCHNG/Goodsandservices12092,2382.02,4532238.54,CREDIT
12/09/2017,Zenith POS Settlement for 12/09/2017,47700.0,4579938.54,CREDIT
12/09/2017,ds374162/cd pius ishaku,250000.0,4829938.54,CREDIT
12/09/2017,"ISW CHARGE:ISW/135604883429/1014794871/Shafing dishes and tumblers//OLU, YEMISI",50.0,4829888.54,DEBIT
12/09/2017,"ISW CHARGE:ISW/135604883435/1014794871/Media campaign//KOLO, PAUL N.",50.0,4829838.54,DEBIT
12/09/2017,Zenith POS Settlement Comm for12/09/2017,576.28,4829262.26,DEBIT
12/09/2017,"ISW/135604883429/1014794871/Shafing dishes and tumblers//OLU, YEMISI",96000.0,4703262.26,CREDIT
13/09/2017,Rvsl:ISW CHARGE:ISW/135604886478/1014794871/Balance for printing work//OMONIYI,50.0,4703312.26,CREDIT
13/09/2017,Rvsl:ISW CHARGE:ISW/135604888048/1014794871/AC//RELAXED MIND INVEST GLOBALCOY,50.0,4703362.26,CREDIT
13/09/2017,NIP/FBN/SUNDAY OLUWASEYIOMOWUMI/FBNMOBILE:WOWBAKERY CONFECTIONERY ANDPASTRIES,350.0,4703712.26,CREDIT
13/09/2017,Zenith POS Settlement for 13/09/2017,5150.0,4708862.26,CREDIT
13/09/2017,NEFT/INTERSWITCHNG/Goodsandservices13092,12555.13,4721417.39,CREDIT
13/09/2017,Zenith POS Settlement for 13/09/2017,16050.0,4737467.39,CREDIT
13/09/2017,Rvsl:ISW/135604886478/1014794871/Balance for printing work//OMONIYIOLUWASOGO AD,20000.0,4757467.39,CREDIT
13/09/2017,Rvsl:ISW/135604888048/1014794871/AC//RELAXED MIND INVESTGLOBAL COY LTD,60000.0,4817467.39,CREDIT
13/09/2017,ds1441551/cd/derek shuaib,462500.0,5279967.39,CREDIT
13/09/2017,"ISW CHARGE:ISW/135604886472/1014794871/Printout//IDOWU, OLUWAFEMI D.",50.0,5279917.39,DEBIT
13/09/2017,ISW CHARGE:ISW/135604886478/1014794871/Balance for printing work//OMONIYIOLUWA,50.0,5279867.39,DEBIT
13/09/2017,ISW CHARGE:ISW/135604888048/1014794871/AC//RELAXED MIND INVEST GLOBALCOY LTD,50.0,5279817.39,DEBIT
13/09/2017,Zenith POS Settlement Comm for13/09/2017,64.38,5279753.01,DEBIT
13/09/2017,Zenith POS Settlement Comm for13/09/2017,188.14,5279564.87,DEBIT
13/09/2017,ISW/135604888048/1014794871/AC//RELAXED MIND INVEST GLOBALCOY LTD,60000.0,5199564.87,CREDIT
13/09/2017,"ISW/135604886472/1014794871/Printout//IDOWU, OLUWAFEMI D.",100000.0,5099564.87,DEBIT
13/09/2017,LEATHER//TRF TO MOSES ALABI,112000.0,4987564.87,DEBIT
14/09/2017,Zenith POS Settlement for 14/09/2017,14200.0,5001764.87,CREDIT
14/09/2017,NEFT/INTERSWITCHNG/Goodsandservices14092,24812.51,5026577.38,CREDIT
14/09/2017,CD/HABIB M/DS305327,184500.0,5211077.38,CREDIT
14/09/2017,ISW CHARGE:ISW/135604889482/1014794871/Acrepairs//RELAXED MINDINVESTMENT GLOB,50.0,5211027.38,DEBIT
14/09/2017,"ISW CHARGE:ISW/135604891521/1014794871/Table phone//OGBONNAYA, SAMUEL C.",50.0,5210977.38,DEBIT
14/09/2017,ISW CHARGE:ISW/135604891570/1014794871/Items bought last week&today//SUNDAYMIC,50.0,5210927.38,DEBIT
14/09/2017,Zenith POS Settlement Comm for14/09/2017,177.51,5210749.87,DEBIT
14/09/2017,AC BREAKER//TRF TO MARGARETYEGRAOWO ODEY,13500.0,5197249.87,DEBIT
14/09/2017,"ISW/135604891521/1014794871/Table phone//OGBONNAYA, SAMUEL C.",26000.0,5171249.87,DEBIT
14/09/2017,ISW/135604889482/1014794871/Acrepairs//RELAXED MINDINVESTMENT GLOBAL COMPANY L,60000.0,5111249.87,DEBIT
14/09/2017,3 SACKS//TRF TO SAYED FARMSLTD-ABUJA A/C,66400.0,5044849.87,DEBIT
14/09/2017,ISW/135604891570/1014794871/Items bought last week&today//SUNDAYMICHIKA JOHN,174900.0,4869949.87,DEBIT
15/09/2017,Zenith POS Settlement for 15/09/2017,3100.0,4873049.87,CREDIT
15/09/2017,NEFT/INTERSWITCHNG/Goodsandservices15092,4764.0,4877813.87,CREDIT
15/09/2017,CD  PIUS ISHAKU/  1013626,150120.0,5027933.87,CREDIT
15/09/2017,ISW CHARGE:ISW/135604892908/1014794871/3Hypes//EZEAKABUDUFORTUNATUS,50.0,5027845.12,CREDIT
15/09/2017,STAMP DUTY CHARGE,900.0,5026945.12,DEBIT
15/09/2017,MIRA BOTTLED WATER//TRF TOMIRA PURIFICATION LTD,55000.0,4971945.12,DEBIT
15/09/2017,ISW/135604892908/1014794871/3Hypes//EZEAKABUDUFORTUNATUS,75000.0,4896945.12,DEBIT
15/09/2017,EMILY 10 AND 3 NAPA//TRF TOEV MIRACLE BAKERS COMPANYNIG LTD,113000.0,4783945.12,DEBIT
17/09/2017,NIP/DBP/GODWIN DANIEL ETIM/NIP- TRF IFO WOW BAKERYCONFECTIONERY AND PASTRIESN,2000.0,4785945.12,CREDIT
18/09/2017,NEFT/INTERSWITCHNG/Goodsandservices17092,3176.0,4789121.12,CREDIT
18/09/2017,NEFT/INTERSWITCHNG/Goodsandservices18092,3870.75,4792991.87,CREDIT
18/09/2017,NEFT/INTERSWITCHNG/Goodsandservices16092,8684.38,4801676.25,CREDIT
18/09/2017,ds23569/cd/derek shuaib,601500.0,5403176.25,CREDIT
18/09/2017,ISW CHARGE:ISW/135604898059/1014794871/Stool//EGWUCHUKWU CHIADIKAOBIUBAKA,50.0,5403126.25,DEBIT
18/09/2017,ISW/135604898059/1014794871/Stool//EGWUCHUKWU CHIADIKAOBIUBAKA,62000.0,5341126.25,DEBIT
19/09/2017,NIP/GTB/ABUTU PRECIOUSPENINNAH/NIP FROM ABUTUPRECIOUS PENINNAH TO WOWBAKERY C,2300.0,5343426.25,CREDIT
19/09/2017,NIP/GTB/BOYE-FAKEYEOLUBUNMI/NIP FROM BOYE-FAKEYE OLUBUNMI TO WOWBAKERY CONFECT,3100.0,5346526.25,CREDIT
19/09/2017,Zenith POS Settlement for 19/09/2017,10900.0,5357426.25,CREDIT
19/09/2017,NEFT/INTERSWITCHNG/GoodsandservicesR1909,16624.38,5374050.63,CREDIT
19/09/2017,Zenith POS Settlement Comm for19/09/2017,136.25,5394114.38,CREDIT
19/09/2017,Zenith POS Settlement Comm for19/09/2017,252.5,5393861.88,DEBIT
20/09/2017,NEFT/INTERSWITCHNG/Goodsandservices20092,5161.0,5399022.88,CREDIT
20/09/2017,Zenith POS Settlement for 20/09/2017,10550.0,5409572.88,CREDIT
20/09/2017,CD/HABIB M/DS30596,576050.0,5985622.88,CREDIT
20/09/2017,Zenith POS Settlement Comm for20/09/2017,131.88,5985491.0,DEBIT
20/09/2017,RV Loc POS 539983xxxx7911190917,595.5,5984895.5,DEBIT
20/09/2017,RV Loc POS 539983xxxx1532190917,1389.5,5983506.0,DEBIT
20/09/2017,RV Loc POS 539983xxxx1532190917,1389.5,5982116.5,DEBIT
20/09/2017,RV Loc POS 539983xxxx3965190917,2183.5,5979933.0,DEBIT
21/09/2017,NIP/DBP/ANISHE OLUMIDEMAYOWA/NIP - TRF IFO WOWBAKERY CONFECTIONERY ANDPASTRIE,800.0,5980733.0,CREDIT
21/09/2017,NEFT/INTERSWITCHNG/Goodsandservices21092,17567.26,5998300.26,CREDIT
21/09/2017,Zenith POS Settlement for 21/09/2017,26700.0,6025000.26,CREDIT
21/09/2017,ISW CHARGE:ISW/135604907582/1014794871/I bagof rice and salt//ABDULLAHI SALIHU,50.0,6024950.26,DEBIT
21/09/2017,Zenith POS Settlement Comm for21/09/2017,333.76,6024616.5,DEBIT
21/09/2017,ISW/135604907582/1014794871/I bagof rice and salt//ABDULLAHI SALIHU,25500.0,5999116.5,DEBIT
21/09/2017,DRINK PURCHASE//TRF TO RHODAFUNMILAYO AMINU,30850.0,5968266.5,DEBIT
22/09/2017,Zenith POS Settlement for 22/09/2017,7300.0,5975566.5,CREDIT
22/09/2017,NEFT/INTERSWITCHNG/Goodsandservices22092,19254.5,5994821.0,CREDIT
22/09/2017,ds309765/cd ruth baba,215600.0,6210421.0,CREDIT
22/09/2017,ds11853/cd/derek shuaib,291500.0,6501921.0,CREDIT
22/09/2017,"ISW CHARGE:ISW/135604910162/1014794871/Printing work//IDOWU, SAMUELADEBAYO",50.0,6501871.0,DEBIT
22/09/2017,SMS Notification Charge Sep 2017,344.0,6501435.74,CREDIT
22/09/2017,STAMP DUTY CHARGE,950.0,6500485.74,DEBIT
22/09/2017,WORK WOOD//TRF TO MOSESALABI,19000.0,6481485.74,DEBIT
22/09/2017,"ISW/135604910162/1014794871/Printing work//IDOWU, SAMUELADEBAYO",65000.0,6416485.74,DEBIT
24/09/2017,"ISW CHARGE:ISW/135604913222/1014794871/Extreme mayonnaise//ALAGBE, SAMSONBABAT",50.0,6416435.74,DEBIT
24/09/2017,ISW CHARGE:ISW/135604913406/1014794871/Cctvfixing//OGAR CLEMENT OGABOR,50.0,6416385.74,DEBIT
24/09/2017,ISW CHARGE:ISW/135604913415/1014794871/7small and 1big//VICTORIA PETER IKANI,50.0,6416335.74,DEBIT
24/09/2017,ISW CHARGE:ISW/135604913553/1014794871/50local chicken//RABIU MUAZU,50.0,6416285.74,DEBIT
24/09/2017,ISW CHARGE:ISW/135604914096/1014794871/Honeywell flour//IBRAHIM  BAKO,50.0,6416235.74,DEBIT
24/09/2017,ISW/135604913406/1014794871/Cctvfixing//OGAR CLEMENT OGABOR,35000.0,6381235.74,DEBIT
24/09/2017,ISW/135604913553/1014794871/50local chicken//RABIU MUAZU,40000.0,6341235.74,DEBIT
24/09/2017,ISW/135604913415/1014794871/7small and 1big//VICTORIA PETER IKANI,44000.0,6297235.74,DEBIT
24/09/2017,3BAGS OF CHICKEN LAPS//TRF TOSAYED FARMS LTD-ABUJA A/C,49600.0,6247635.74,DEBIT
24/09/2017,"ISW/135604913222/1014794871/Extreme mayonnaise//ALAGBE, SAMSONBABATUNDE",84000.0,6163635.74,DEBIT
24/09/2017,ISW/135604914096/1014794871/Honeywell flour//IBRAHIM  BAKO,1695000.0,4468635.74,DEBIT
25/09/2017,NEFT/INTERSWITCHNG/Goodsandservices25092,3573.01,4472208.75,CREDIT
25/09/2017,NEFT/INTERSWITCHNG/Goodsandservices23092,13448.38,4485657.13,CREDIT
25/09/2017,NEFT/INTERSWITCHNG/Goodsandservices24092,17716.13,4503373.26,CREDIT
26/09/2017,Zenith POS Settlement for 26/09/2017,7150.0,5040523.26,CREDIT
26/09/2017,NEFT/INTERSWITCHNG/Goodsandservices26092,12852.88,5053376.14,CREDIT
26/09/2017,Zenith POS Settlement for 26/09/2017,36550.0,5089926.14,CREDIT
26/09/2017,DS168154/CD/DEREK SHUAIB,396000.0,5485926.14,CREDIT
26/09/2017,ISW CHARGE:ISW/135604920672/1014794871/Airfreight//SGK GLOBAL SHIPPINGSERVICE,50.0,5485876.14,DEBIT
26/09/2017,Zenith POS Settlement Comm for26/09/2017,89.38,5485786.76,DEBIT
26/09/2017,Zenith POS Settlement Comm for26/09/2017,456.91,5485329.85,DEBIT
26/09/2017,SUPPLY OF LAPS 7SACKS//TRF TOSAYED FARMS LTD-ABUJA A/C,130000.0,5355329.85,DEBIT
26/09/2017,ISW/135604920672/1014794871/Airfreight//SGK GLOBAL SHIPPINGSERVICES,548410.74,4806919.11,CREDIT
27/09/2017,Zenith POS Settlement for 27/09/2017,3750.0,4810669.11,CREDIT
27/09/2017,NEFT/INTERSWITCHNG/Goodsandservices27092,16475.51,4827144.62,CREDIT
27/09/2017,Zenith POS Settlement Comm for27/09/2017,46.88,4827097.74,DEBIT
27/09/2017,AMANDA AND EMILY//TRF TO    EVMIRACLE BAKERS COMPANY NIGLTD,170000.0,4657097.74,DEBIT
28/09/2017,Zenith POS Settlement for 28/09/2017,2100.0,4659197.74,CREDIT
28/09/2017,NEFT/INTERSWITCHNG/Goodsandservices28092,9031.76,4668229.5,CREDIT
28/09/2017,DS208502/CD/HABIB NMARY,258000.0,4926229.5,CREDIT
28/09/2017,Zenith POS Settlement Comm for28/09/2017,26.25,4926203.25,DEBIT
28/09/2017,ISW CHARGE:ISW/135604925984/1014794871/Duste flour supply//AKINOLA GBEMISOLASU,50.0,4926153.25,DEBIT
28/09/2017,ISW CHARGE:ISW/135604926571/1014794871/473ml mayonnaise//ALAGBE  SAMSONBABATUN,50.0,4926053.25,CREDIT
28/09/2017,ISW CHARGE:ISW/135604926840/1014794871/Gearbox//DE OJOKOS NIGERIA LTD,50.0,4926003.25,DEBIT
28/09/2017,ISW/135604926571/1014794871/473ml mayonnaise//ALAGBE  SAMSONBABATUNDE,50000.0,4876003.25,DEBIT
28/09/2017,ISW/135604926840/1014794871/Gearbox//DE OJOKOS NIGERIA LTD,60000.0,4816003.25,DEBIT
28/09/2017,ISW/135604926563/1014794871/Special bread//APEX PACKAGINGLIMITED,100000.0,4716003.25,DEBIT
28/09/2017,ISW/135604925984/1014794871/Duste flour supply//AKINOLA GBEMISOLASULIAT,1130000.0,3586003.25,DEBIT
29/09/2017,NEFT/INTERSWITCHNG/Goodsandservices29092,4615.13,3590618.38,CREDIT
29/09/2017,Zenith POS Settlement for 29/09/2017,8500.0,3599118.38,CREDIT
29/09/2017,Rvsl ISW/135604926571/473mlmayonnaise//,50000.0,3649118.38,CREDIT
29/09/2017,Rvsl ISW/135604926563/Specialbread//APE,100000.0,3749118.38,CREDIT
29/09/2017,DS150744/CD/DEREK SHUIABU,238500.0,3987618.38,CREDIT
29/09/2017,Rvsl ISW/135604925984/Duste floursupply,1130000.0,5117618.38,CREDIT
29/09/2017,ISW CHARGE:ISW/135604930877/1014794871/Flour to duste//AKINOLA GBEMISOLASULIAT,50.0,5117568.38,DEBIT
29/09/2017,Zenith POS Settlement Comm for29/09/2017,106.26,5117462.12,DEBIT
29/09/2017,STAMP DUTY CHARGE,950.0,5116512.12,DEBIT
29/09/2017,ISW/135604930877/1014794871/Flour to duste//AKINOLA GBEMISOLASULIAT,1130000.0,3986512.12,DEBIT
30/09/2017,ISW CHARGE:ISW/135604932065/1014794871/Small mayonnise//ALAGBE  SAMSONBABATUND,50.0,3986412.12,CREDIT
30/09/2017,ISW CHARGE:ISW/135604932069/1014794871/Special bread nylons//APEX PACKAGINGLIM,50.0,3986362.12,DEBIT
30/09/2017,Acct Maint. Fee + VAT,11088.41,3975273.71,DEBIT
30/09/2017,ISW/135604932059/1014794871/Transportation of goods//SGK GLOBALSHIPPING SERVICE,30000.0,3945273.71,DEBIT
30/09/2017,ISW/135604932065/1014794871/Small mayonnise//ALAGBE  SAMSONBABATUNDE,50000.0,3895273.71,DEBIT
30/09/2017,ISW/135604932069/1014794871/Special bread nylons//APEX PACKAGINGLIMITED,100000.0,3795273.71,DEBIT
01/10/2017,NIP/FBN/ANENE TOCHUKWUURSULA/USSD_ANENETOCHUKWU URSULA,1500.0,3796773.71,CREDIT
01/10/2017,"ISW CHARGE:ISW/135604933133/1014794871/5cartons oil//OGBADA, JONAH",50.0,3796723.71,DEBIT
01/10/2017,"ISW/135604933133/1014794871/5cartons oil//OGBADA, JONAH",75000.0,3721723.71,DEBIT
01/10/2017,ICE CREAM MIX//TRF TO ISAAC GNKEMDILIM,96000.0,3625723.71,DEBIT
02/10/2017,NIP/ABN/OPEYEMI ELIZABETHODUOYE/FT//WOW BAK/OPEYEMI,1500.0,3627223.71,CREDIT
03/10/2017,NIP/FBN/ANENE TOCHUKWUURSULA/USSD_ANENETOCHUKWU URSULA,1100.0,3628323.71,CREDIT
03/10/2017,NIP/FBN/ANENE TOCHUKWUURSULA/USSD_ANENETOCHUKWU URSULA,1100.0,3629423.71,CREDIT
03/10/2017,NIP/FBN/ANENE TOCHUKWUURSULA/USSD_ANENETOCHUKWU URSULA,1100.0,3630523.71,CREDIT
03/10/2017,"NIP/GTB/MOHAMMED  AISHAKARMA/NIP FROM MOHAMMED,AISHA KARMA TO WOW BAKERYCONFE",1600.0,3633513.21,CREDIT
03/10/2017,NEFT/INTERSWITCHNG/Goodsandservices01102,11463.41,3644976.62,CREDIT
03/10/2017,NEFT/INTERSWITCHNG/Goodsandservices30092,15185.27,3660161.89,CREDIT
03/10/2017,NIP/DBP/JAKONDA  ADAILILAYWI/NIP - TRF IFO WOW BAKERYCONFECTIONERY AND PASTRI,20000.0,3680161.89,CREDIT
03/10/2017,Zenith POS Settlement for 03/10/2017,45550.0,3725711.89,CREDIT
03/10/2017,"NIP/GTB/UGO EMMANUELIKECHUKWU/NIP FROMUGO,EMMANUEL,IKECHUKWU TOWOW BAKERY CON",51200.0,3776911.89,CREDIT
03/10/2017,DS 197160 DEREK S,361500.0,4138411.89,CREDIT
03/10/2017,ds65347/cd ruth baba,750000.0,4888411.89,CREDIT
03/10/2017,ISW CHARGE:ISW/135604937454/1014794871/Duste Rent//EMEKA SAMUELAGBARAKWE,50.0,4888361.89,DEBIT
03/10/2017,ISW CHARGE:ISW/135604939663/1014794871/5kgcartons icing sugar//ABIODUNOLAYIN,50.0,4888311.89,DEBIT
03/10/2017,Zenith POS Settlement Comm for03/10/2017,569.4,4887742.49,CREDIT
03/10/2017,ISW/135604939663/1014794871/5kgcartons icing sugar//ABIODUNOLAYIN AYEBAMERU,54000.0,4833742.49,DEBIT
03/10/2017,ISW/135604937454/1014794871/Duste Rent//EMEKA SAMUELAGBARAKWE,1200000.0,3633742.49,DEBIT
04/10/2017,Zenith POS Settlement for 04/10/2017,800.0,3634542.49,CREDIT
04/10/2017,Zenith POS Settlement for 04/10/2017,1000.0,3635542.49,CREDIT
04/10/2017,NIP/FBN/OGINNI OLUWABUSAYOTITUS/USSD_OGINNIOLUWABUSAYO TITUS,15000.0,3650542.49,CREDIT
04/10/2017,Zenith POS Settlement Comm for04/10/2017,10.0,3650532.49,DEBIT
04/10/2017,ISW CHARGE:ISW/135604942703/1014794871/Brain box//OBINNA UGBOJA,50.0,3650469.99,CREDIT
04/10/2017,ISW/135604942703/1014794871/Brain box//OBINNA UGBOJA,35000.0,3615469.99,DEBIT
05/10/2017,"NIP/GTB/OTUMEMENAANTHONY/NIP FROM OTUMEMENA,ANTHONY TO WOW BAKERYCONFECTIONE",1700.0,3617169.99,CREDIT
05/10/2017,NIP/GTB/NAHUCHE USMANABUBAKAR/NIP FROM NAHUCHEUSMAN ABUBAKAR TO WOWBAKERY CON,1750.0,3618919.99,CREDIT
05/10/2017,NIP/GTB/ORANUGO  ELOCHUKWUHILLARY/NIP FROM ORANUGOELOCHUKWU HILLARY TO WOW BA,7000.0,3625919.99,CREDIT
05/10/2017,cshd ep79656/ pius ishaku,50000.0,3675919.99,CREDIT
05/10/2017,ds 237230 habib mary,445960.0,4121879.99,CREDIT
05/10/2017,ISW CHARGE:ISW/135604945082/1014794871/Kitchen items last week//SUNDAYMICHIKA,50.0,4121829.99,DEBIT
05/10/2017,ISW CHARGE:ISW/135604947221/1014794871/Motor//OKEGOD TECHNICAL NIGERIALIMITED,50.0,4121779.99,DEBIT
05/10/2017,ISW/135604947221/1014794871/Motor//OKEGOD TECHNICAL NIGERIALIMITED,65000.0,4056779.99,DEBIT
05/10/2017,ISW/135604945082/1014794871/Kitchen items last week//SUNDAYMICHIKA JOHN,158200.0,3898579.99,DEBIT
06/10/2017,NEFT/INTERSWITCHNG/Goodsandservices06102,10878.81,3909458.8,CREDIT
06/10/2017,NIP/DBP/JAKONDA  ADAILILAYWI/NIP - TRF IFO WOW BAKERYCONFECTIONERY AND PASTRI,12000.0,3921458.8,CREDIT
06/10/2017,NIP/FBN/OGINNI OLUWABUSAYOTITUS/USSD_OGINNIOLUWABUSAYO TITUS,13000.0,3934458.8,CREDIT
06/10/2017,Zenith POS Settlement for 06/10/2017,15500.0,3949958.8,CREDIT
06/10/2017,ds 89448 derek shaib,162500.0,4128458.8,CREDIT
06/10/2017,ISW CHARGE:ISW/135604959099/1014794871/Preservative//KWAME TWUM AMPOFO,50.0,4128408.8,DEBIT
06/10/2017,Zenith POS Settlement Comm for06/10/2017,193.75,4128215.05,DEBIT
06/10/2017,STAMP DUTY CHARGE,1350.0,4126865.05,DEBIT
06/10/2017,ISW/135604959099/1014794871/Preservative//KWAME TWUM AMPOFO,38000.0,4088865.05,DEBIT
08/10/2017,NIP/DBP/UTOR TERFALEONARD/NIP - TRF IFO WOWBAKERY CONFECTIONERY ANDPASTRIES N,2200.0,4091065.05,CREDIT
08/10/2017,NIP/FBN/ANENE TOCHUKWUURSULA/USSD_ANENETOCHUKWU URSULA,2500.0,4093565.05,CREDIT
09/10/2017,NEFT/INTERSWITCHNG/Goodsandservices09102,6947.52,4100512.57,CREDIT
09/10/2017,NEFT/INTERSWITCHNG/Goodsandservices07102,11116.01,4111628.58,CREDIT
09/10/2017,NEFT/INTERSWITCHNG/Goodsandservices08102,12803.27,4124431.85,CREDIT
09/10/2017,CD/DEREK S/DS254389,159000.0,4283431.85,CREDIT
09/10/2017,csh de[p138713/ pius jacob,291020.0,4574451.85,CREDIT
09/10/2017,ISW CHARGE:ISW/135605192567/1014794871/Balance bread nylon//APEX PACKAGINGLIMI,50.0,4574401.85,DEBIT
09/10/2017,ISW CHARGE:ISW/135605192688/1014794871/Mamagold delivery//AKINOLAGBEMISOLA SUL,50.0,4574351.85,DEBIT
09/10/2017,ISW CHARGE:ISW/135605192884/1014794871/Pans for bread//ABUBAKAR ABDULLAHI,50.0,4574301.85,DEBIT
09/10/2017,ISW/135605192567/1014794871/Balance bread nylon//APEX PACKAGINGLIMITED,120200.0,4454101.85,DEBIT
09/10/2017,ISW/135605192884/1014794871/Pans for bread//ABUBAKAR ABDULLAHI,150000.0,4304101.85,DEBIT
10/10/2017,NEFT/INTERSWITCHNG/Goodsandservices18092,1935.38,2611037.23,CREDIT
10/10/2017,NEFT/INTERSWITCHNG/Goodsandservices10102,19899.64,2630936.87,CREDIT
10/10/2017,Zenith POS Settlement for 10/10/2017,22850.0,2653786.87,CREDIT
10/10/2017,Zenith POS Settlement for 10/10/2017,36350.0,2690136.87,CREDIT
10/10/2017,CD/PAULINA/LINFIX SOLUTIONLTD/DS259565,150000.0,2840136.87,CREDIT
10/10/2017,CD/PAULINA/DEREKSHAUIB/DS254418,152500.0,2992636.87,CREDIT
10/10/2017,ISW CHARGE:ISW/135605196306/1014794871/Dangote sugar//ABUBAKAR MUSTAPHAALHAJI,50.0,2992586.87,DEBIT
10/10/2017,ISW CHARGE:ISW/135605196376/1014794871/Cook brand&improver//CHIDONUGOANOZIE  A,50.0,2992536.87,DEBIT
10/10/2017,ISW CHARGE:ISW/135605196434/1014794871/Family loaf nylon//YUSTECH POLY NIGENTE,50.0,2992486.87,DEBIT
10/10/2017,ISW CHARGE:ISW/135605196785/1014794871/Rim//TAIWO JOHN OLADELE,50.0,2992436.87,DEBIT
10/10/2017,Zenith POS Settlement Comm for10/10/2017,135.64,2992301.23,DEBIT
10/10/2017,Zenith POS Settlement Comm for10/10/2017,454.39,2991846.84,DEBIT
10/10/2017,ISW/135605196785/1014794871/Rim//TAIWO JOHN OLADELE,25000.0,2966846.84,DEBIT
10/10/2017,ISW/135605196376/1014794871/Cook brand&improver//CHIDONUGOANOZIE  AND  BROS NIG,117000.0,2849846.84,DEBIT
10/10/2017,CHICKEN LAPS FRM SAYED//TRFTO SAYED FARMS LTD-ABUJA A/C,141000.0,2708846.84,DEBIT
10/10/2017,ISW/135605196434/1014794871/Family loaf nylon//YUSTECH POLY NIGENTERPRISES,144000.0,2564846.84,DEBIT
10/10/2017,ISW/135605196306/1014794871/Dangote sugar//ABUBAKAR MUSTAPHAALHAJI,164500.0,2250346.84,CREDIT
11/10/2017,DS1437515/CD RUTH BABA,200000.0,2450346.84,CREDIT
11/10/2017,CD/HABIB M/DS168699,263000.0,2713346.84,CREDIT
12/10/2017,NEFT/INTERSWITCHNG/Goodsandservices12102,12108.5,2725455.34,CREDIT
12/10/2017,Zenith POS Settlement for 12/10/2017,26300.0,2751755.34,CREDIT
12/10/2017,cd/habib mary/ds168961,153500.0,2905255.34,CREDIT
12/10/2017,Zenith POS Settlement Comm for12/10/2017,328.76,2904926.58,DEBIT
13/10/2017,Zenith POS Settlement for 13/10/2017,9850.0,2914776.58,CREDIT
13/10/2017,NEFT/INTERSWITCHNG/Goodsandservices13102,15234.89,2930011.47,CREDIT
13/10/2017,CD/DEREK S/DS172918,105500.0,3035511.47,CREDIT
13/10/2017,"ISW CHARGE:ISW/135605204691/1014794871/Groundnut oil//BABA, RUTH MAMA",50.0,3035461.47,DEBIT
13/10/2017,"ISW CHARGE:ISW/135605205491/1014794871/Partfor bus//SULEIMAN, HAMZA",50.0,3035411.47,DEBIT
13/10/2017,Zenith POS Settlement Comm for13/10/2017,123.13,3035288.34,CREDIT
13/10/2017,STAMP DUTY CHARGE,1050.0,3034238.34,DEBIT
13/10/2017,"ISW/135605205491/1014794871/Partfor bus//SULEIMAN, HAMZA",3500.0,3030738.34,DEBIT
13/10/2017,"ISW/135605204691/1014794871/Groundnut oil//BABA, RUTH MAMA",109000.0,2921738.34,DEBIT
16/10/2017,"NIP/GTB/IBEZIM  HENRILYNNCHUKWUEBUKA/NIP FROM IBEZIM,HENRILYNN CHUKWUEBUKA TO",1100.0,2922838.34,CREDIT
16/10/2017,NEFT/INTERSWITCHNG/Goodsandservices16102,17120.65,2939958.99,CREDIT
16/10/2017,NEFT/INTERSWITCHNG/Goodsandservices15102,32603.66,2972562.65,CREDIT
16/10/2017,NEFT/INTERSWITCHNG/Goodsandservices14102,44166.29,3016728.94,CREDIT
16/10/2017,CD/DERAK S/DS218792,163000.0,3179728.94,CREDIT
16/10/2017,ISW CHARGE:ISW/135605220421/1014794871/Bread nylon orange//VIVO&TECHINDUSTRIES,50.0,3780078.94,CREDIT
16/10/2017,ISW/135605220421/1014794871/Bread nylon orange//VIVO&TECHINDUSTRIES LIMITED,450000.0,3330078.94,DEBIT
17/10/2017,ETZ-000003396658;onyekachion/1014794871,1000.0,3331078.94,CREDIT
17/10/2017,"NIP/GTB/HAMZA  RUTH ADI/NIPFROM HAMZA, RUTH ADI TO WOWBAKERY CONFECTIONERY AND",2100.0,3333178.94,CREDIT
17/10/2017,NEFT/INTERSWITCHNG/Goodsandservices17102,19304.15,3352483.09,CREDIT
17/10/2017,Zenith POS Settlement for 17/10/2017,38050.0,3390533.09,CREDIT
17/10/2017,Zenith POS Settlement for 17/10/2017,57000.0,3447533.09,CREDIT
17/10/2017,ISW CHARGE:ISW/135605223360/1014794871/Services//TAIWO JOHN OLADELE,50.0,3447483.09,DEBIT
17/10/2017,ISW CHARGE:ISW/135605224234/1014794871/Genservice oct//IHEANACHO ANTHONYEWUZI,50.0,3447433.09,DEBIT
17/10/2017,Zenith POS Settlement Comm for17/10/2017,475.68,3446957.41,CREDIT
17/10/2017,Zenith POS Settlement Comm for17/10/2017,708.15,3446249.26,CREDIT
17/10/2017,TRF FRM WOW BAKERYCONFECTIONERY AND PASTRIESNI TO|ISW/135605224234/1014794871,17000.0,3429249.26,DEBIT
17/10/2017,ISW/135605223360/1014794871/Services//TAIWO JOHN OLADELE,48000.0,3381249.26,DEBIT
17/10/2017,VALIDO BUTTER&TAPE//TRF TO EVMIRACLE BAKERS COMPANY NIGLTD,94500.0,3286749.26,DEBIT
18/10/2017,Rvsl:ISW CHARGE:ISW/135605226870/1014794871/Motor for cooling fan//BAKERY SUPPO,50.0,3286799.26,CREDIT
18/10/2017,Zenith POS Settlement for 18/10/2017,13300.0,3300099.26,CREDIT
18/10/2017,Rvsl:TRF FRM WOW BAKERYCONFECTIONERY AND PASTRIESNI TO |ISW/135605226870/10147,45000.0,3371102.76,CREDIT
18/10/2017,10453 CD/ EMMA,130000.0,3501102.76,CREDIT
18/10/2017,DS678418/CD/DEREK SHUAIB,200000.0,3701102.76,CREDIT
18/10/2017,ISW CHARGE:ISW/135605226868/1014794871/Tshirts//SAMOLIVER CLOTHIERS,50.0,3701052.76,DEBIT
18/10/2017,ISW CHARGE:ISW/135605226870/1014794871/Motor for cooling fan//BAKERY SUPPORTSE,50.0,3701002.76,DEBIT
18/10/2017,Zenith POS Settlement Comm for18/10/2017,166.27,3700836.49,CREDIT
18/10/2017,TRF FRM WOW BAKERYCONFECTIONERY AND PASTRIESNI TO|ISW/135605226868/1014794871,34000.0,3666836.49,DEBIT
18/10/2017,TRF FRM WOW BAKERYCONFECTIONERY AND PASTRIESNI TO|ISW/135605226870/1014794871,45000.0,3621836.49,DEBIT
18/10/2017,"DANO MILK,SUGAR&SALT//TRF TOYUSUF   HARUNA",347400.0,3274436.49,DEBIT
19/10/2017,Rvsl:ISW CHARGE:ISW/135605227599/1014794871/Oven repairs duste//CHIGBO  STEPHEN,50.0,3274486.49,CREDIT
19/10/2017,NIP/GTB/KAREEM RIDWANOLUWAFEMI/NIP FROM KAREEMRIDWAN  OLUWAFEMI  TO WOWBAKER,1200.0,3275686.49,CREDIT
19/10/2017,Zenith POS Settlement for 19/10/2017,6600.0,3282286.49,CREDIT
19/10/2017,NEFT/INTERSWITCHNG/Goodsandservices19102,12555.13,3294841.62,CREDIT
19/10/2017,Rvsl:TRF FRM WOW BAKERYCONFECTIONERY AND PASTRIESNI TO |ISW/135605227599/10147,50000.0,3344841.62,CREDIT
19/10/2017,DS1713393/CD RUTH BABA,150000.0,3494841.62,CREDIT
19/10/2017,ds0736913/cd/habib mary,167500.0,3662341.62,CREDIT
19/10/2017,ISW CHARGE:ISW/135605227603/1014794871/Fanmotor for duste bakery//BAKERYSUPPO,50.0,3662241.62,CREDIT
19/10/2017,Zenith POS Settlement Comm for19/10/2017,82.5,3662159.12,DEBIT
19/10/2017,CAT FISH//TRF TO MICHAEL OKOAKOBI,18750.0,3643409.12,DEBIT
19/10/2017,TRF FRM WOW BAKERYCONFECTIONERY AND PASTRIESNI TO|ISW/135605227603/1014794871,45000.0,3598409.12,DEBIT
19/10/2017,TRF FRM WOW BAKERYCONFECTIONERY AND PASTRIESNI TO|ISW/135605227599/1014794871,50000.0,3548409.12,DEBIT
20/10/2017,NEFT/INTERSWITCHNG/Goodsandservices20102,11860.39,3560269.51,CREDIT
20/10/2017,Zenith POS Settlement for 20/10/2017,16650.0,3576919.51,CREDIT
20/10/2017,CD/HABIB M/DS0742750,134500.0,3711419.51,CREDIT
20/10/2017,"ISW CHARGE:ISW/135605229818/1014794871/Butter,preservative &fruits//ODOR FIDELI",50.0,3711369.51,DEBIT
20/10/2017,Zenith POS Settlement Comm for20/10/2017,208.16,3711161.35,CREDIT
20/10/2017,STAMP DUTY CHARGE,1150.0,3710011.35,DEBIT
20/10/2017,TRF FRM WOW BAKERYCONFECTIONERY AND PASTRIESNI TO|ISW/135605229818/1014794871,900000.0,2810011.35,DEBIT
22/10/2017,NIP/ABN/GENEVIEVE GODWINMICHAEL/FT//WOW BAK/GENEVIE,900.0,2810911.35,CREDIT
22/10/2017,NIP/DBP/MBA IJEOMAOBIANUJU/NIP - TRF IFO WOWBAKERY CONFECTIONERY ANDPASTRIES,3700.0,2814611.35,CREDIT
22/10/2017,ISW CHARGE:ISW/135605233609/1014794871/60pan covers//ABUBAKAR ABDULLAHI,50.0,2814561.35,DEBIT
23/10/2017,NEFT/INTERSWITCHNG/Goodsandservices23102,9131.0,2763692.35,CREDIT
23/10/2017,ISW ATMPyt-000254495510-INDESTATE SHARADA 2   KANOKN,12000.0,2775692.35,CREDIT
23/10/2017,NEFT/INTERSWITCHNG/Goodsandservices21102,12455.88,2788148.23,CREDIT
23/10/2017,NEFT/INTERSWITCHNG/Goodsandservices22102,13051.39,2801199.62,CREDIT
23/10/2017,ISW ATMPyt-000240453706-Stanbic@Lokoja Branch   LokojaKO,100000.0,2901199.62,CREDIT
23/10/2017,DS669884/CD/DEREK SHUAIB,242500.0,3143699.62,CREDIT
23/10/2017,DS1711262/CD RUTH BABA,350000.0,3493699.62,CREDIT
23/10/2017,ISW CHARGE:ISW/135605235414/1014794871/55local chicken//ABDULLAHI MUSA,50.0,3493649.62,DEBIT
23/10/2017,ISW CHARGE:ISW/135605235460/1014794871/5bread basket//ODOR FIDELISCHUKWUEMEKA,50.0,3493599.62,DEBIT
23/10/2017,TRF FRM WOW BAKERYCONFECTIONERY AND PASTRIESNI TO|ISW/135605235460/1014794871,11500.0,3482099.62,DEBIT
23/10/2017,TRF FRM WOW BAKERYCONFECTIONERY AND PASTRIESNI TO|ISW/135605235414/1014794871,46750.0,3435349.62,DEBIT
24/10/2017,Rvsl:ISW CHARGE:ISW/135605238912/1014794871/Balance for bread pans//ABUBAKAR AB,50.0,3435399.62,CREDIT
24/10/2017,Rvsl:ISW CHARGE:ISW/135605239033/1014794871/Balance of bread pans//ABUBAKAR ABD,50.0,3435449.62,CREDIT
24/10/2017,NEFT/INTERSWITCHNG/Goodsandservices24102,2183.5,3437633.12,CREDIT
24/10/2017,Zenith POS Settlement for 24/10/2017,19200.0,3456833.12,CREDIT
24/10/2017,Rvsl:ISW/135605239033/1014794871/Balance of bread pans//ABUBAKARABDULLAHI,50000.0,3556833.12,CREDIT
24/10/2017,DS0208864/CD/DEREK SAMUEL,127000.0,3683833.12,CREDIT
24/10/2017,ISW CHARGE:ISW/135605238912/1014794871/Balance for bread pans//ABUBAKARABDULLA,50.0,3683783.12,DEBIT
24/10/2017,ISW CHARGE:ISW/135605239033/1014794871/Balance of bread pans//ABUBAKARABDULLAH,50.0,3683733.12,DEBIT
24/10/2017,Zenith POS Settlement Comm for24/10/2017,240.01,3683493.11,CREDIT
24/10/2017,ISW/135605238912/1014794871/Balance for bread pans//ABUBAKARABDULLAHI,50000.0,3633493.11,DEBIT
24/10/2017,ISW/135605239033/1014794871/Balance of bread pans//ABUBAKARABDULLAHI,50000.0,3583493.11,DEBIT
24/10/2017,"STK BUTTER,ROMI,//TRF TO EVMIRACLE BAKERS COMPANY NIGLTD",145400.0,3438093.11,DEBIT
24/10/2017,8SACKS OF CHICKEN LAPS//TRFTO SAYED FARMS LTD-ABUJA A/C,156000.0,3282093.11,DEBIT
25/10/2017,Zenith POS Settlement for 25/10/2017,4500.0,3286593.11,CREDIT
25/10/2017,NEFT/INTERSWITCHNG/Goodsandservices25102,9429.44,3296022.55,CREDIT
25/10/2017,CD/HABIB M/DS680917,231050.0,3527072.55,CREDIT
25/10/2017,Zenith POS Settlement Comm for25/10/2017,56.26,3527016.29,DEBIT
25/10/2017,PAYMENT FOR PET DRINKS//TRFTO RHODA FUNMILAYO AMINU,25150.0,3501866.29,DEBIT
26/10/2017,NEFT/INTERSWITCHNG/Goodsandservices26102,12356.64,3514222.93,CREDIT
26/10/2017,Zenith POS Settlement for 26/10/2017,15050.0,3529272.93,CREDIT
26/10/2017,ISW CHARGE:ISW/135605243027/1014794871/20bags of golden penny//IBRAHIMBAKO,50.0,3529222.93,DEBIT
26/10/2017,Zenith POS Settlement Comm for26/10/2017,188.16,3528984.77,CREDIT
26/10/2017,ISW/135605243395/1014794871/Tilapia fish and others//SHAIKA DANSUMA,73000.0,3455984.77,DEBIT
26/10/2017,ISW/135605243027/1014794871/20bags of golden penny//IBRAHIMBAKO,332000.0,3123984.77,DEBIT
27/10/2017,NEFT/INTERSWITCHNG/Goodsandservices27102,1935.38,3125920.15,CREDIT
27/10/2017,Zenith POS Settlement for 27/10/2017,3000.0,3128920.15,CREDIT
27/10/2017,ds153465/cd ruth baba,105020.0,3233940.15,CREDIT
27/10/2017,cd/madam chinyere 05652,115000.0,3348940.15,CREDIT
27/10/2017,DS671141/CD/DEREK SHUAIB,204000.0,3552940.15,CREDIT
27/10/2017,Zenith POS Settlement Comm for27/10/2017,37.5,3552902.65,DEBIT
27/10/2017,STAMP DUTY CHARGE,1050.0,3551852.65,DEBIT
28/10/2017,SMS Notification Charge Oct 2017,616.0,3551236.65,DEBIT
29/10/2017,MC Loc ATM Pyt-000361230519--Plot2293 Cadastral ZoneA3 WuseFC,5000.0,3556236.65,CREDIT
29/10/2017,ISW CHARGE:ISW/135605250381/1014794871/Small pans//ABUBAKAR ABDULLAHI,50.0,3556186.65,DEBIT
29/10/2017,ISW/135605250381/1014794871/Small pans//ABUBAKAR ABDULLAHI,60000.0,3496186.65,DEBIT
30/10/2017,NEFT/INTERSWITCHNG/Goodsandservices28102,3721.89,3499908.54,CREDIT
30/10/2017,Zenith POS Settlement for 30/10/2017,16750.0,3516658.54,CREDIT
30/10/2017,NEFT/INTERSWITCHNG/Goodsandservices30102,17517.64,3534176.18,CREDIT
30/10/2017,054894cd/UMAZAYI OJO,125000.0,3659176.18,CREDIT
30/10/2017,327669/CD/PIUS ISHAKU,280000.0,3939176.18,CREDIT
30/10/2017,ds792008/cd/derek shuaib,322500.0,4261676.18,CREDIT
30/10/2017,ISW CHARGE:ISW/135605251750/1014794871/Refillof gas cylinders//UGWU EBENEZER,50.0,4261626.18,DEBIT
30/10/2017,ISW CHARGE:ISW/135605251865/1014794871/Stereo for nylon//AYODEJI AIYESIMI,50.0,4261576.18,DEBIT
30/10/2017,ISW/135605251865/1014794871/Stereo for nylon//AYODEJI AIYESIMI,60000.0,4201366.78,CREDIT
30/10/2017,ISW/135605251750/1014794871/Refillof gas cylinders//UGWU EBENEZER,64000.0,4137366.78,CREDIT
31/10/2017,Zenith POS Settlement for 31/10/2017,17450.0,4154816.78,CREDIT
31/10/2017,NEFT/INTERSWITCHNG/Goodsandservices31102,26946.4,4181763.18,CREDIT
31/10/2017,ISW CHARGE:ISW/135605256010/1014794871/Cabels and box//ANYANWU EZENWAKINGSLEY,50.0,4181713.18,DEBIT
31/10/2017,Zenith POS Settlement Comm for31/10/2017,218.15,4181495.03,CREDIT
31/10/2017,C/B RVSL MCPOS SETT-170918190317-180917,1600.0,4179895.03,DEBIT
31/10/2017,Acct Maint. Fee + VAT,8329.56,4171565.47,CREDIT
31/10/2017,ISW/135605256010/1014794871/Cabels and box//ANYANWU EZENWAKINGSLEY,68000.0,4103565.47,DEBIT
31/10/2017,DANO MILK 5BAGS//TRF TOCAROLINE NGOZI ATTAH,135000.0,3968565.47,DEBIT
01/11/2017,Zenith POS Settlement for 01/11/2017,5450.0,3974015.47,CREDIT
01/11/2017,NEFT/INTERSWITCHNG/Goodsandservices01112,12902.52,3986917.99,CREDIT
01/11/2017,CD/DEREK S/DS789022,144000.0,4130917.99,CREDIT
01/11/2017,CD/DEREK S/DS784517,305000.0,4435917.99,CREDIT
01/11/2017,ISW CHARGE:ISW/135605258623/1014794871/1stNovember//KWAME TWUM AMPOFO,50.0,4435867.99,DEBIT
01/11/2017,Zenith POS Settlement Comm for01/11/2017,68.14,4435799.85,CREDIT
01/11/2017,ISW/135605258623/1014794871/1stNovember//KWAME TWUM AMPOFO,150000.0,4285799.85,DEBIT
02/11/2017,NEFT/INTERSWITCHNG/Goodsandservices02112,2977.5,4288777.35,CREDIT
02/11/2017,Zenith POS Settlement for 02/11/2017,3100.0,4291877.35,CREDIT
02/11/2017,31237 CD/ MADAM CHINYERE,20000.0,4311877.35,CREDIT
02/11/2017,csh dep24646/ pius ishaku,100000.0,4411877.35,CREDIT
02/11/2017,Zenith POS Settlement Comm for02/11/2017,38.75,4411838.6,DEBIT
03/11/2017,NEFT/INTERSWITCHNG/Goodsandservices03112,13498.0,4433836.6,CREDIT
03/11/2017,CD/ DEREK S,274500.0,4708336.6,CREDIT
03/11/2017,ISW CHARGE:ISW/135605265566/1014794871/Bread nylon for small loaf//AYODEJI AIYE,50.0,4708286.6,DEBIT
03/11/2017,Zenith POS Settlement Comm for03/11/2017,106.26,4708180.34,DEBIT
03/11/2017,STAMP DUTY CHARGE,1000.0,4707180.34,DEBIT
03/11/2017,ISW/135605265566/1014794871/Bread nylon for small loaf//AYODEJIAIYESIMI,80000.0,4627180.34,DEBIT
05/11/2017,"NIP/GTB/ALHASSAN  YUSRAMUHTAR/NIP FROM ALHASSAN,YUSRA MUHTAR TO WOW BAKERYCON",2300.0,4629480.34,CREDIT
05/11/2017,ISW CHARGE:ISW/135605268942/1014794871/Repairs for slicer//BAKO LONGTONGBITRUS,50.0,4629430.34,DEBIT
05/11/2017,ISW/135605268942/1014794871/Repairs for slicer//BAKO LONGTONGBITRUS,38000.0,4591430.34,DEBIT
05/11/2017,LAPS OF CHICKEN 7 SACKS//TRFTO SAYED FARMS LTD-ABUJA A/C,140000.0,4451430.34,DEBIT
06/11/2017,NEFT/INTERSWITCHNG/Goodsandservices04112,4764.0,4456194.34,CREDIT
06/11/2017,NEFT/INTERSWITCHNG/Goodsandservices06112,8436.25,4464630.59,CREDIT
06/11/2017,NEFT/INTERSWITCHNG/Goodsandservices05112,19453.03,4484083.62,CREDIT
06/11/2017,Zenith POS Settlement for 06/11/2017,26300.0,4510383.62,CREDIT
06/11/2017,ISW ATMPyt-004114356968-Ajaokuta3              Kogi           ,138000.0,4648383.62,CREDIT
06/11/2017,DS 826256/CD/ DURAKI S,659900.0,5308283.62,CREDIT
06/11/2017,ISW CHARGE:ISW/135605291699/1014794871/October pay//JESSICA  SARNIYO,50.0,5308233.62,DEBIT
06/11/2017,ISW CHARGE:ISW/135605291708/1014794871/Lastmonth//ALPHONSUS OGWIHI ODEY,50.0,5308133.62,CREDIT
06/11/2017,ISW CHARGE:ISW/135605291718/1014794871/Salary for last month//ATILOLA KOLASAMS,50.0,5308083.62,DEBIT
06/11/2017,ISW CHARGE:ISW/135605293254/1014794871/Duste payment//JULIUS A OBARO,50.0,5308033.62,DEBIT
06/11/2017,ISW CHARGE:ISW/135605293256/1014794871/Bread production//GODWIN JEREMIAHAKPABO,50.0,5307983.62,DEBIT
06/11/2017,ISW CHARGE:ISW/135605293259/1014794871/Food payment for october//GODIYAYAKUBU,50.0,5307933.62,DEBIT
06/11/2017,Zenith POS Settlement Comm for06/11/2017,278.76,5307654.86,DEBIT
06/11/2017,ISW/135605291699/1014794871/October pay//JESSICA  SARNIYO,25000.0,5282654.86,DEBIT
06/11/2017,OCT PAYMENT//TRF TO JOHNSONMMADUABUCHI EGEMUKA,35000.0,5247654.86,DEBIT
06/11/2017,ISW/135605293259/1014794871/Food payment for october//GODIYAYAKUBU,35000.0,5212654.86,DEBIT
06/11/2017,ISW/135605291708/1014794871/Lastmonth//ALPHONSUS OGWIHI ODEY,40000.0,5172654.86,DEBIT
06/11/2017,ISW/135605293256/1014794871/Bread production//GODWIN JEREMIAHAKPABOT,45000.0,5127654.86,DEBIT
06/11/2017,ISW/135605291718/1014794871/Salary for last month//ATILOLA KOLASAMSON,50000.0,5077654.86,DEBIT
06/11/2017,ICE CREAM MIX ONSATURDAY//TRF TO ISAAC GNKEMDILIM,64000.0,5013654.86,DEBIT
06/11/2017,ISW/135605293254/1014794871/Duste payment//JULIUS A OBARO,69400.0,4944254.86,DEBIT
06/11/2017,ISW/135605291704/1014794871/Salary//GADA  LUQMAN,80000.0,4864254.86,DEBIT
07/11/2017,Zenith POS Settlement for 07/11/2017,6810.0,4872057.36,CREDIT
07/11/2017,ISW CHARGE:ISW/135605293460/1014794871/Supply of flour and sugar part//IBRAHIM,50.0,4872007.36,DEBIT
07/11/2017,ISW CHARGE:ISW/135605293461/1014794871/Supply of 6cartons of icing sugar//ABIOD,50.0,4871957.36,DEBIT
07/11/2017,ISW CHARGE:ISW/135605293462/1014794871/6small cylinders for refill//VICTORIA P,50.0,4871907.36,DEBIT
07/11/2017,Zenith POS Settlement Comm for07/11/2017,85.13,4871822.23,DEBIT
07/11/2017,ISW/135605293462/1014794871/6small cylinders for refill//VICTORIAPETER IKANI,24000.0,4847822.23,DEBIT
07/11/2017,ISW/135605293461/1014794871/Supply of 6cartons of icingsugar//ABIODUN OLAYIN AY,64800.0,4783022.23,DEBIT
07/11/2017,SUGAR DANGOTE//TRF TO YUSUFHARUNA,110000.0,4673022.23,DEBIT
07/11/2017,ISW/135605293460/1014794871/Supply of flour and sugar part//IBRAHIMBAKO,1800000.0,2873022.23,CREDIT
08/11/2017,NEFT/INTERSWITCHNG/Goodsandservices08112,5309.88,2878332.11,CREDIT
08/11/2017,"NIP/GTB/ADEMOLA  ISIAKAFOLORUNSHO/NIP FROMADEMOLA, ISIAKA FOLORUNSHOTO WOW BA",7500.0,2885832.11,CREDIT
08/11/2017,Zenith POS Settlement for 08/11/2017,9650.0,2895482.11,CREDIT
08/11/2017,Transfer Charge + VAT,52.5,2895429.61,DEBIT
08/11/2017,Transfer Charge + VAT,52.5,2895377.11,DEBIT
08/11/2017,Zenith POS Settlement Comm for08/11/2017,120.64,2895256.47,CREDIT
08/11/2017,ISW/135605298735/1014794871/Items bought on 31st//SUNDAY MICHIKAJOHN,186550.0,2708706.47,DEBIT
08/11/2017,ISW/135605298733/1014794871/Flour balance//IBRAHIM  BAKO,430000.0,2278706.47,DEBIT
09/11/2017,Zenith POS Settlement for 09/11/2017,2600.0,2281306.47,CREDIT
09/11/2017,CD/ MADAM CHINENE 58865,140000.0,2424929.1,CREDIT
09/11/2017,CD/HABIB MARY/DS789256,200500.0,2625429.1,CREDIT
09/11/2017,Zenith POS Settlement Comm for09/11/2017,32.51,2625396.59,CREDIT
09/11/2017,Transfer Charge + VAT,52.5,2625344.09,DEBIT
09/11/2017,"ISW/135605298939/1014794871/WOW bakery Tithes//GEN. ACCT FORTITHES, OFFERI",100000.0,2525344.09,DEBIT
09/11/2017,DANO MILK 6BAGS//TRF TOCAROLINE NGOZI ATTAH,162000.0,2363344.09,DEBIT
10/11/2017,Zenith POS Settlement for 10/11/2017,13700.0,2377044.09,CREDIT
10/11/2017,NEFT/INTERSWITCHNG/Goodsandservices10112,13845.4,2390889.49,CREDIT
10/11/2017,35439cd/madam chinyere,34000.0,2424889.49,CREDIT
10/11/2017,CD/DEREK SHUAIB/DS784416,147000.0,2571889.49,CREDIT
10/11/2017,Zenith POS Settlement Comm for10/11/2017,171.26,2571718.23,CREDIT
10/11/2017,STAMP DUTY CHARGE,950.0,2570768.23,DEBIT
10/11/2017,CAT FISH PURCHASE//TRF TOMICHAEL OKO AKOBI,18750.0,2552018.23,DEBIT
12/11/2017,NIP/FCMB/4706598017/QR/Q10000390326/Fund Trf/1014794871,1150.0,2553168.23,CREDIT
12/11/2017,"NIP/GTB/ELOJI  ARINZE EKENE/NIPFROM ELOJI, ARINZE EKENE TOWOW BAKERY CONFECTIO",2200.0,2555368.23,CREDIT
12/11/2017,"NIP/GTB/ETIM  FELI-RITANTEKIM/NIP FROM ETIM, FELI-RITANTEKIM TO WOW BAKERY CON",2400.0,2557768.23,CREDIT
12/11/2017,Transfer Charge + VAT,52.5,2557715.73,DEBIT
12/11/2017,Transfer Charge + VAT,52.5,2557663.23,DEBIT
12/11/2017,ISW/135605304327/1014794871/Preservative 2bags//KWAME TWUMAMPOFO,74000.0,2483663.23,DEBIT
12/11/2017,ISW/135605305145/1014794871/Gasrefill for both bakeries//UGWUEBENEZER,80000.0,2403663.23,DEBIT
13/11/2017,NEFT/INTERSWITCHNG/Goodsandservices12112,694.75,2404357.98,CREDIT
13/11/2017,NEFT/INTERSWITCHNG/Goodsandservices11112,15086.01,2427781.0,CREDIT
13/11/2017,ds5602486/cd pius ishaku,331500.0,2759281.0,CREDIT
13/11/2017,DS 678064/CD/ DEREK S,353000.0,3112281.0,CREDIT
13/11/2017,Transfer Charge + VAT,52.5,3112228.5,DEBIT
13/11/2017,ISW/135605308055/1014794871/Local chicken 40//ABDULLAHI MUSA,34000.0,3078228.5,DEBIT
14/11/2017,Zenith POS Settlement for 14/11/2017,11250.0,3089478.5,CREDIT
14/11/2017,Transfer Charge + VAT,52.5,3089426.0,DEBIT
14/11/2017,Transfer Charge + VAT,52.5,3089373.5,DEBIT
14/11/2017,Zenith POS Settlement Comm for14/11/2017,140.65,3089232.85,DEBIT
14/11/2017,ISW/135605310118/1014794871/Redgolf fixing//JAMIU ABDULAZEEZ,30000.0,3059232.85,DEBIT
14/11/2017,ISW/135605308974/1014794871/Oki5gallons&solive//EYA BROSS NIGLTD,98500.0,2960732.85,DEBIT
14/11/2017,CHICKEN LAPS 8BAGS//TRF TOSAYED FARMS LTD-ABUJA A/C,159700.0,2801032.85,DEBIT
14/11/2017,"SUGAR,SALT AND LIQUIDMILK//TRF TO YUSUF   HARUNA",184400.0,2616632.85,DEBIT
15/11/2017,NIP/FDP/IBHADON AIGBEMENH/770 TRANSFER FROM IBHADONAIGBEMEN H **,1800.0,2618432.85,CREDIT
15/11/2017,NEFT/INTERSWITCHNG/Goodsandservices15112,2680.25,2621113.1,CREDIT
15/11/2017,Zenith POS Settlement for 15/11/2017,3500.0,2624613.1,CREDIT
15/11/2017,CD/ MADAM CHINYERE 03017,140000.0,2764613.1,CREDIT
15/11/2017,CD/MARY HABIB/DS683318,392500.0,3157113.1,CREDIT
15/11/2017,Zenith POS Settlement Comm for15/11/2017,43.75,3157069.35,DEBIT
15/11/2017,Transfer Charge + VAT,52.5,3157016.85,DEBIT
15/11/2017,Transfer Charge + VAT,52.5,3156964.35,DEBIT
15/11/2017,ISW/135605312917/1014794871/Balance money//JAMIU ABDULAZEEZ,6000.0,3150964.35,DEBIT
15/11/2017,ISW/135605311257/1014794871/Preservative new 2bags//UGOMAT NIGENTERPRISES,52000.0,3098964.35,DEBIT
16/11/2017,Zenith POS Settlement for 16/11/2017,550.0,3099514.35,CREDIT
16/11/2017,01708CD/ MADAM CHINYERE,22300.0,3123203.85,CREDIT
16/11/2017,CD/HABIB MERCY/DS0741781,118000.0,3241203.85,CREDIT
16/11/2017,Zenith POS Settlement Comm for16/11/2017,6.88,3241196.97,DEBIT
16/11/2017,Transfer Charge + VAT,52.5,3241144.47,DEBIT
16/11/2017,ISW/135605314447/1014794871/Pay//KWAME TWUM AMPOFO,30000.0,3211144.47,DEBIT
17/11/2017,NIP/DBP/DIVIB INTERNATIONALLTD ACCT 2/NIP - TRF IFO WOWBAKERY CONFECTIONERY AN,20000.0,3231144.47,CREDIT
17/11/2017,CD/DEREK SHUAIB/DS,164000.0,3395144.47,CREDIT
17/11/2017,Transfer Charge + VAT,52.5,3395091.97,DEBIT
17/11/2017,Transfer Charge + VAT,52.5,3395039.47,DEBIT
17/11/2017,STAMP DUTY CHARGE,900.0,3394139.47,DEBIT
17/11/2017,ISW/135605316087/1014794871/Fireextinguisher service//ALIYU MAHMUD,31500.0,3362639.47,DEBIT
17/11/2017,ISW/135605316089/1014794871/Balance for t shirts//SAMOLIVERCLOTHIERS,40000.0,3322639.47,DEBIT
19/11/2017,Transfer Charge + VAT,52.5,3322586.97,DEBIT
19/11/2017,Transfer Charge + VAT,52.5,3322534.47,DEBIT
19/11/2017,ISW/135605339332/1014794871/Bead pan man//ABUBAKAR ABDULLAHI,25000.0,3297534.47,DEBIT
19/11/2017,ISW/135605329503/1014794871/41local chicken//ABDULLAHI MUSA,30800.0,3266734.47,DEBIT
20/11/2017,RvPosNotOnusFEE 17110218342002/11/2017,12.0,3266746.47,CREDIT
20/11/2017,NEFT/INTERSWITCHNG/Goodsandservices19112,1786.5,3268532.97,CREDIT
20/11/2017,NEFT/INTERSWITCHNG/Goodsandservices20112,30172.02,3298704.99,CREDIT
20/11/2017,ISW ATMPyt-000740302949-16/11/2017,150000.0,3448704.99,CREDIT
20/11/2017,dp0996155/pius ishaku,301400.0,3750104.99,CREDIT
20/11/2017,CD/DEREK S/DS0736559,356500.0,4106604.99,CREDIT
20/11/2017,Transfer Charge + VAT,52.5,4106552.49,DEBIT
20/11/2017,Transfer Charge + VAT,52.5,4106499.99,DEBIT
20/11/2017,Transfer Charge + VAT,52.5,4106447.49,DEBIT
20/11/2017,ISW/135605339746/1014794871/Eggs 20crates//SWIFT PLUS FARMSPRODUCE LIMITED,18000.0,4086847.49,CREDIT
20/11/2017,ISW/135605339753/1014794871/5gas refill for gwarimpa//MAX GAS,20000.0,4066847.49,DEBIT
20/11/2017,"ISW/135605340815/1014794871/Tilapia,crocker&sausage//SHAIKADANSUMA",45000.0,4021847.49,DEBIT
20/11/2017,SUGAR 10BAGS FOR PREMIX//TRFTO YUSUF   HARUNA,167000.0,3854847.49,DEBIT
21/11/2017,NEFT/INTERSWITCHNG/Goodsandservices21112,397.0,3855244.49,CREDIT
21/11/2017,Zenith POS Settlement for 21/11/2017,10350.0,3865594.49,CREDIT
21/11/2017,Zenith POS Settlement for 21/11/2017,24950.0,3890544.49,CREDIT
21/11/2017,064641cd/ojo umazayo,70000.0,3960544.49,CREDIT
21/11/2017,CD/DEREK S/DS675075,248500.0,4209044.49,CREDIT
21/11/2017,Transfer Charge + VAT,52.5,4208991.99,DEBIT
21/11/2017,Transfer Charge + VAT,52.5,4208939.49,DEBIT
21/11/2017,Transfer Charge + VAT,52.5,4208886.99,DEBIT
21/11/2017,Zenith POS Settlement Comm for21/11/2017,129.38,4208757.61,DEBIT
21/11/2017,Zenith POS Settlement Comm for21/11/2017,311.88,4208445.73,DEBIT
21/11/2017,ISW/135605343261/1014794871/Finishing touches on golf//JAMIUABDULAZEEZ,19000.0,4189445.73,CREDIT
21/11/2017,STK 10 CARTONS&BREADTAPE//TRF TO DAVISON NNAMEZIE,91000.0,4098445.73,DEBIT
21/11/2017,ISW/135605343673/1014794871/Cash//BABA EBENEZER SHESHI,100000.0,3998445.73,DEBIT
21/11/2017,ISW/135605343268/1014794871/Mamagold part payment//IBRAHIM  BAKO,1000000.0,2998445.73,DEBIT
22/11/2017,RVSL MC POS COMM171109111412 091117,5.0,2998450.73,CREDIT
22/11/2017,"NIP/GTB/CHRISTIAN   EZE MIRABELOGOCHU/NIP FROM CHRISTIAN ,EZE MIRABEL OGOCHU T",2200.0,3000650.73,CREDIT
22/11/2017,NIP/FBN/ANYANWU DICKSONIKECHUKWU/USSD_ANYANWUDICKSON IKECHUKWU,18400.0,3019050.73,CREDIT
22/11/2017,RVSL MC POS 171109111412091117,400.0,3252650.73,CREDIT
22/11/2017,GWARIMPA DANO MILK//TRF TOCAROLINE NGOZI ATTAH,159000.0,3093650.73,DEBIT
23/11/2017,POS Settlement for2057FC999999440-23/11/2017,1700.0,3095350.73,CREDIT
23/11/2017,NEFT/INTERSWITCHNG/Goodsandservices23112,6451.25,3101801.98,CREDIT
23/11/2017,ds126348/cd ruth baba,100000.0,3201801.98,CREDIT
23/11/2017,CD/HABIB M/DS0943498,194000.0,3395801.98,CREDIT
23/11/2017,POS Settlement Comm for2057FC999999440-23/11/2017,68.0,3395733.98,DEBIT
23/11/2017,BIG&SMALL FOIL//TRF TO OGECHICHINONSO MADU,34000.0,3361733.98,DEBIT
23/11/2017,MOTOR ELECTRIC//TRF TO OJIAKAUNIQUE VENTURES,55000.0,3306733.98,DEBIT
24/11/2017,Rvsl:Transfer Charge + VAT,52.5,3306786.48,CREDIT
24/11/2017,NEFT/INTERSWITCHNG/Goodsandservices24112,2729.38,3309515.86,CREDIT
24/11/2017,NIP/FBN/ANYANWU DICKSONIKECHUKWU/USSD_ANYANWUDICKSON IKECHUKWU,34500.0,3344015.86,CREDIT
24/11/2017,Rvsl:ISW/135605349940/1014794871/Bus repair duste//JAMIUABDULAZEEZ,48000.0,3392015.86,CREDIT
24/11/2017,Transfer Charge + VAT,52.5,3391963.36,DEBIT
24/11/2017,STAMP DUTY CHARGE,900.0,3391063.36,DEBIT
24/11/2017,STATEMENT OF ACCOUNTCHARGE,1197.0,3389866.36,DEBIT
24/11/2017,ISW/135605349940/1014794871/Busrepair duste//JAMIU ABDULAZEEZ,48000.0,3341866.36,DEBIT
24/11/2017,SALT 5BAGS&SUGAR 10BAGS//TRFTO YUSUF   HARUNA,175000.0,3166866.36,DEBIT
25/11/2017,NIP/FBN/OGINNI OLUWABUSAYOTITUS/USSD_OGINNIOLUWABUSAYO TITUS,10000.0,3176866.36,CREDIT
25/11/2017,Transfer Charge + VAT,52.5,3176813.86,DEBIT
25/11/2017,Transfer Charge + VAT,52.5,3176761.36,DEBIT
25/11/2017,SMS Notification Charge Nov 2017,488.0,3176273.36,DEBIT
25/11/2017,ISW/135605353223/1014794871/6small&2big refill//MAX GAS,56000.0,3100273.36,CREDIT
25/11/2017,50 BUCKETS COOKBRAND//TRF TODAVISON NNAMEZIE,439000.0,2661273.36,DEBIT
27/11/2017,"NIP/GTB/YUGUDA  HAMZA R./NIPFROM YUGUDA, HAMZA R. TOWOW BAKERY CONFECTIONERY A",12000.0,2673273.36,CREDIT
27/11/2017,dp5507010/pius ishaku,300300.0,2973573.36,CREDIT
27/11/2017,CD/DEREK S/DS163859,470500.0,3444073.36,CREDIT
27/11/2017,Transfer Charge + VAT,52.5,3444020.86,DEBIT
27/11/2017,ISW/135605355437/1014794871/Nylon big plain//APEX PACKAGINGLIMITED,93650.0,3350370.86,DEBIT
27/11/2017,CHICKEN LAPS FRM SAYEDFARMS//TRF TO SAYED FARMSLTD-ABUJA A/C,138000.0,3212370.86,DEBIT
28/11/2017,POS Settlement for2057FC999999440-28/11/2017,400.0,3212770.86,CREDIT
28/11/2017,CD/DEREK S/DS011865,317500.0,3530270.86,CREDIT
28/11/2017,POS Settlement Comm for2057FC999999440-28/11/2017,16.0,3530254.86,DEBIT
28/11/2017,Transfer Charge + VAT,52.5,3530202.36,DEBIT
28/11/2017,Transfer Charge + VAT,52.5,3530149.86,DEBIT
28/11/2017,Transfer Charge + VAT,52.5,3530097.36,DEBIT
28/11/2017,ISW/135605388571/1014794871/Eggdelivered yesterday//SWIFT PLUSFARMS PRODUCE LI,18000.0,3512097.36,DEBIT
28/11/2017,ISW/135605388563/1014794871/Complete work on bus//JAMIUABDULAZEEZ,21000.0,3491097.36,DEBIT
28/11/2017,ISW/135605389665/1014794871/Tyres//ISHAKU  PIUS,21000.0,3470097.36,DEBIT
29/11/2017,Rvsl:Transfer Charge + VAT,52.5,3470149.86,CREDIT
29/11/2017,Rvsl:Transfer Charge + VAT,52.5,3470202.36,CREDIT
29/11/2017,ds162140/cd ruth baba,55600.0,3525802.36,CREDIT
29/11/2017,Rvsl:ISW/135605391674/1014794871/Cakes boxes 10&12//RAINBOWTOUCH LTD,66600.0,3592402.36,CREDIT
29/11/2017,CD/DEREK S/DS014791,380500.0,4039502.36,CREDIT
29/11/2017,Transfer Charge + VAT,52.5,4039449.86,DEBIT
29/11/2017,Transfer Charge + VAT,52.5,4039397.36,DEBIT
29/11/2017,Transfer Charge + VAT,52.5,4039344.86,DEBIT
29/11/2017,ISW/135605391674/1014794871/Cakes boxes 10&12//RAINBOW TOUCHLTD,66600.0,3972744.86,DEBIT
29/11/2017,ISW/135605391723/1014794871/10&12inches cake boxes//INE THELMAAKO,66600.0,3906144.86,DEBIT
29/11/2017,ISW/135605394396/1014794871/12&10inches boxes for cakes//THELMAAKO INE,66600.0,3839544.86,DEBIT
29/11/2017,10BAGS OF SUGAR TODAY//TRFTO YUSUF   HARUNA,164000.0,3675544.86,DEBIT
30/11/2017,REFUND OF EXCESS POS FEE,57.75,3675602.61,CREDIT
30/11/2017,NIP/GTB/OLAJORIN VICTORAJIBOLA/NIP FROM OLAJORINVICTOR AJIBOLA TO WOW BAKERYC,1100.0,3676702.61,CREDIT
30/11/2017,NIP/FBN/KWAKI DANISHAKU/USSD_KWAKI DAN ISHAKU,1200.0,3677902.61,CREDIT
30/11/2017,NEFT/INTERSWITCHNG/Goodsandservices30112,2183.5,3680086.11,CREDIT
30/11/2017,DS162096/CD/OIUS ISHAKU,35000.0,3715086.11,CREDIT
30/11/2017,028555CD/OJO UMAZAYI,158000.0,3873086.11,CREDIT
30/11/2017,Transfer Charge + VAT,52.5,3873033.61,DEBIT
30/11/2017,Transfer Charge + VAT,52.5,3872981.11,DEBIT
30/11/2017,Transfer Charge + VAT,52.5,3872928.61,DEBIT
30/11/2017,Acct Maint. Fee + VAT,8852.17,3864076.44,DEBIT
30/11/2017,ISW/135605395751/1014794871/Fixing of blue golf//TAIWO JOHNOLADELE,19500.0,3844576.44,DEBIT
30/11/2017,ISW/135605399060/1014794871/28local chicken//ABDULLAHI MUSA,22400.0,3822176.44,DEBIT
30/11/2017,ISW/135605394528/1014794871/Bread nylon orange and red//VIVO&TECHINDUSTRIES LIM,660000.0,3162176.44,DEBIT
01/12/2017,Transfer Charge + VAT,52.5,3162123.94,DEBIT
01/12/2017,STAMP DUTY CHARGE,600.0,3161523.94,DEBIT
01/12/2017,ISW/135605411380/1014794871/Partpayment of salary//GADA  LUQMAN,50000.0,3081523.94,CREDIT
02/12/2017,Transfer Charge + VAT,52.5,3081471.44,DEBIT
02/12/2017,ISW/135605412686/1014794871/Balance of flour supplied lastwee//IBRAHIM  BAKO,1750000.0,1331471.44,DEBIT
04/12/2017,NIP/FBN/ANENE TOCHUKWUURSULA/USSD_ANENETOCHUKWU URSULA,2100.0,1333571.44,CREDIT
04/12/2017,7402CD/MADAM CHINYERE,131000.0,1464571.44,CREDIT
04/12/2017,CD/DEREK S/DS107276,294000.0,1758571.44,CREDIT
04/12/2017,DS121403/CD=RUTH BABA,900000.0,2658571.44,CREDIT
04/12/2017,Transfer Charge + VAT,52.5,2658518.94,DEBIT
04/12/2017,ISW/135605413864/1014794871/Balance for small bread nylon//AYODEJIAIYESIMI,110000.0,2548518.94,DEBIT
04/12/2017,DANO 5&SUGAR 10//TRF TO YUSUFHARUNA,300400.0,2248118.94,DEBIT
05/12/2017,42813 CD MARSHAL ACHARA,1750.0,2249868.94,CREDIT
05/12/2017,CD/OSANA 9389,7900.0,2257768.94,CREDIT
05/12/2017,NIP/FBN/KOLO CHRISTIEKASHI/FBNMOBILE:WOW BAKERYCONFECTIONERY AND PASTRIESNI,20000.0,2277768.94,CREDIT
05/12/2017,9279 cd/ madam chinyere,75400.0,2353168.94,CREDIT
05/12/2017,4832/CD KWAME TUUM AMPOTO,180000.0,2533168.94,CREDIT
05/12/2017,Transfer Charge + VAT,52.5,2533116.44,DEBIT
05/12/2017,Transfer Charge + VAT,52.5,2533063.94,DEBIT
05/12/2017,Transfer Charge + VAT,52.5,2533011.44,DEBIT
05/12/2017,Transfer Charge + VAT,52.5,2532958.94,DEBIT
05/12/2017,Transfer Charge + VAT,52.5,2532906.44,DEBIT
05/12/2017,PAYMENT FOR NOV//TRF TOISMAIL ENEMONA   IDRIS,22575.0,2510331.44,DEBIT
05/12/2017,ISW/135605418415/1014794871/Payfor last month work//OZOGBOOLUCHI,29000.0,2481331.44,DEBIT
05/12/2017,ISW/135605419702/1014794871/45local chicken//ABDULLAHI MUSA,36000.0,2445331.44,DEBIT
05/12/2017,ISW/135605418423/1014794871/2bigand 9small//MAX GAS,65000.0,2330331.44,CREDIT
05/12/2017,STK BUTTER&ROMI//TRF TO    EVMIRACLE BAKERS COMPANY NIGLTD,106600.0,2223731.44,DEBIT
05/12/2017,ISW/135605418333/1014794871/Payfor consulting//KWAME TWUMAMPOFO,116000.0,2107731.44,DEBIT
05/12/2017,10 STK ROYAL YEAST//TRF TODAVISON NNAMEZIE,157500.0,1950231.44,DEBIT
06/12/2017,NIP/FBN/ANYANWU DICKSONIKECHUKWU/USSD_ANYANWUDICKSON IKECHUKWU,23000.0,1973231.44,CREDIT
06/12/2017,DS073216/CD/HABIB MARY,169300.0,2142531.44,CREDIT
06/12/2017,Transfer Charge + VAT,52.5,2142478.94,DEBIT
06/12/2017,Transfer Charge + VAT,52.5,2142426.44,DEBIT
06/12/2017,Transfer Charge + VAT,52.5,2142373.94,DEBIT
06/12/2017,PAYMENT FOR NOV WORKDONE//TRF TO JOHNSONMMADUABUCHI EGEMUKA,35000.0,2107373.94,DEBIT
06/12/2017,ISW/135605422358/1014794871/Salary payment duste//GODWINJEREMIAH AKPABOT,40000.0,2067373.94,DEBIT
06/12/2017,JOB PAY//TRF TO AKOBI MATTHEWOGAR,50000.0,2017373.94,DEBIT
06/12/2017,ISW/135605422419/1014794871/Salary for proj manager//UGOH VICTORCHUKWUDI,50000.0,1967373.94,DEBIT
06/12/2017,ISW/135605422356/1014794871/Novsalary duste//JULIUS A OBARO,70000.0,1897373.94,DEBIT
07/12/2017,DS151662/CD RUTH BABA,76000.0,1973373.94,CREDIT
07/12/2017,DS073897/CD/HABIB MARY,209500.0,2182873.94,CREDIT
07/12/2017,Transfer Charge + VAT,52.5,2182821.44,DEBIT
07/12/2017,"ISW/135605423206/1014794871/Trademark//AUGUSTINE, MOSES",40000.0,2142821.44,DEBIT
07/12/2017,FOR 5BAGS SALT AND 10BAGSSUGAR//TRF TO YUSUF   HARUNA,175000.0,1967821.44,DEBIT
08/12/2017,POS Settlement for2057FC999999440-08/12/2017,14850.0,1982671.44,CREDIT
08/12/2017,NEFT/INTERSWITCHNG/Goodsandservices08122,22083.13,2004754.57,CREDIT
08/12/2017,CD MR. OJO UMAZAYI 4638636,100000.0,2180754.57,CREDIT
08/12/2017,69640CD/ MADAM CHINYERE,110000.0,2290754.57,CREDIT
08/12/2017,Transfer Charge + VAT,52.5,2290702.07,DEBIT
08/12/2017,Transfer Charge + VAT,52.5,2290649.57,DEBIT
08/12/2017,POS Settlement Comm for2057FC999999440-08/12/2017,185.64,2290463.93,CREDIT
08/12/2017,STAMP DUTY CHARGE,900.0,2289563.93,DEBIT
08/12/2017,HALF BUCKET CAT FISH//TRF TOMICHAEL OKO AKOBI,10750.0,2278813.93,DEBIT
08/12/2017,ISW/135605425491/1014794871/Keyboard lesson last payment//KALU .L.CHIKA,40000.0,2238813.93,DEBIT
08/12/2017,ISW/135605427690/1014794871/Icingsugar delivered yesterday5c//ABIODUN OLAYIN A,54000.0,2184813.93,DEBIT
08/12/2017,CHICKEN LAPS FOR TODAY//TRFTO SAYED FARMS LTD-ABUJA A/C,134300.0,2050513.93,CREDIT
09/12/2017,"NIP/GTB/YUGUDA  HAMZA R./NIPFROM YUGUDA, HAMZA R. TOWOW BAKERY CONFECTIONERY A",15000.0,2065513.93,CREDIT
09/12/2017,Transfer Charge + VAT,52.5,2065461.43,DEBIT
09/12/2017,PRESERVATIVE FRM GARKI//TRFTO DAVISON NNAMEZIE,28000.0,2037461.43,DEBIT
09/12/2017,ISW/135605429381/1014794871/Lights for chirstmas//ENEHMMADUABUCHI CHAMBERLINE,35000.0,2002461.43,DEBIT
11/12/2017,NEFT/INTERSWITCHNG/Goodsandservices09122,8237.75,2010699.18,CREDIT
11/12/2017,NEFT/INTERSWITCHNG/Goodsandservices11122,20495.14,2031194.32,CREDIT
11/12/2017,NEFT/INTERSWITCHNG/Goodsandservices10122,22380.89,2053575.21,CREDIT
11/12/2017,044409 CD OJIO,50000.0,2103575.21,CREDIT
11/12/2017,POS Settlement for2057FC999999440-11/12/2017,83550.0,2187125.21,CREDIT
11/12/2017,DS348763/CD/DEREK SHUI=AIB,356500.0,2543625.21,CREDIT
11/12/2017,csh dep231432/ pius ishaku,600000.0,3143625.21,CREDIT
11/12/2017,POS Settlement Comm for2057FC999999440-11/12/2017,1019.4,3142605.81,DEBIT
12/12/2017,POS Settlement for2057FC999999440-12/12/2017,18450.0,3173313.21,CREDIT
12/12/2017,Transfer Charge + VAT,52.5,3173260.71,DEBIT
12/12/2017,POS Settlement Comm for2057FC999999440-12/12/2017,230.63,3173030.08,DEBIT
12/12/2017,2 CARTONS MIX FOR ICECREAM//TRF TO ISAAC GNKEMDILIM,64000.0,3109030.08,DEBIT
12/12/2017,ISW/135605434400/1014794871/Carrier bags part payment//APEXPACKAGING LIMITED,150000.0,2959030.08,DEBIT
12/12/2017,DANGOTE SUGAR 10BAGS//TRF TOYUSUF   HARUNA,164000.0,2795030.08,DEBIT
13/12/2017,NEFT/INTERSWITCHNG/Goodsandservices13122,12704.0,2807734.08,CREDIT
13/12/2017,DS036656/CD PIUS ISHAKU,50000.0,2857734.08,CREDIT
13/12/2017,POS Settlement for2057FC999999440-13/12/2017,57150.0,2914884.08,CREDIT
13/12/2017,DFS389553/CD/HABIB MARY,569200.0,3484084.08,CREDIT
13/12/2017,Transfer Charge + VAT,52.5,3484031.58,DEBIT
13/12/2017,POS Settlement Comm for2057FC999999440-13/12/2017,189.38,3483842.2,DEBIT
13/12/2017,ISW/135605447863/1014794871/Signage for habib//GODWIN CHUKWUMASUNDAY,60000.0,3423842.2,DEBIT
14/12/2017,POS Settlement for2057FC999999440-14/12/2017,6300.0,3430142.2,CREDIT
14/12/2017,NEFT/INTERSWITCHNG/Goodsandservices14122,6848.25,3436990.45,CREDIT
14/12/2017,ds251253/cd/habib mary,229500.0,3666490.45,CREDIT
14/12/2017,Transfer Charge + VAT,52.5,3666437.95,DEBIT
14/12/2017,Transfer Charge + VAT,52.5,3666385.45,DEBIT
14/12/2017,Transfer Charge + VAT,52.5,3666332.95,DEBIT
14/12/2017,POS Settlement Comm for2057FC999999440-14/12/2017,78.75,3666254.2,DEBIT
14/12/2017,ISW/135605448534/1014794871/Money for bringing back d bigbus//.JULIUS INNOCENT,20000.0,3646254.2,DEBIT
14/12/2017,"ISW/135605448548/1014794871/Tithes for November//GEN. ACCT FORTITHES, OFFERI",90000.0,3520254.2,CREDIT
14/12/2017,DANO SUPPLY ON THURSDAY//TRFTO CAROLINE NGOZI ATTAH,156000.0,3364254.2,DEBIT
15/12/2017,NEFT/INTERSWITCHNG/Goodsandservices15122,5161.01,3369415.21,CREDIT
15/12/2017,18151 cd/ madam chinyere,82000.0,3451415.21,CREDIT
15/12/2017,ds380100/cd/derek shuaib,269000.0,3720415.21,CREDIT
15/12/2017,Transfer Charge + VAT,52.5,3720362.71,DEBIT
15/12/2017,Transfer Charge + VAT,52.5,3720310.21,DEBIT
15/12/2017,Transfer Charge + VAT,52.5,3720257.71,DEBIT
15/12/2017,STAMP DUTY CHARGE,1000.0,3719257.71,DEBIT
15/12/2017,ISW/135605452950/1014794871/Repairs for Ac//RELAXED MIND INVESTGLOBAL COY LTD,20000.0,3699257.71,DEBIT
15/12/2017,1BAG OF PRESERVARIVE//TRF TODAVISON NNAMEZIE,29000.0,3670257.71,DEBIT
15/12/2017,ISW/135605452968/1014794871/Balance for carrier bags and plain//APEXPACKAGING L,100000.0,3570257.71,DEBIT
15/12/2017,ISW/135605452339/1014794871/Flour supply last week//IBRAHIM  BAKO,1700000.0,1870257.71,DEBIT
16/12/2017,TRF FRM EMEKA VALENTINEUNEGBU TO WOW BAKERYCONFECTIONERY AND PASTRIESNI|payme,1200.0,1871457.71,CREDIT
16/12/2017,ISW ATMPyt-000261062091-Stanbic@Lokoja Branch   LokojaKO,31000.0,1902457.71,CREDIT
16/12/2017,NIP/ABN/OLUSEYI ABIODUNEKUNDAYO/FT/David and D/WOWBAK/OLUSEYI,230000.0,2132457.71,CREDIT
16/12/2017,Transfer Charge + VAT,52.5,2132405.21,DEBIT
16/12/2017,Transfer Charge + VAT,52.5,2132352.71,DEBIT
16/12/2017,Transfer Charge + VAT,52.5,2132300.21,DEBIT
16/12/2017,ISW/135605455332/1014794871/Mechanic//.JULIUS INNOCENT,6000.0,2126300.21,DEBIT
16/12/2017,ISW/135605455189/1014794871/Payment today//Samuel,37500.0,2088800.21,DEBIT
17/12/2017,Transfer Charge + VAT,52.5,1588747.71,CREDIT
17/12/2017,ISW/135605456072/1014794871/20bags of sugar&2 bags of flour//IBRAHIMBAKO,349000.0,1239747.71,DEBIT
18/12/2017,NEFT/INTERSWITCHNG/Goodsandservices18122,3275.25,1243022.96,CREDIT
18/12/2017,NEFT/INTERSWITCHNG/Goodsandservices17122,5359.5,1248382.46,CREDIT
18/12/2017,NEFT/INTERSWITCHNG/Goodsandservices16122,11910.0,1260292.46,CREDIT
18/12/2017,DS91723/CD RUTHBABA,215250.0,1475542.46,CREDIT
18/12/2017,DS 330902/CD/ DEREK S,888000.0,2363542.46,CREDIT
18/12/2017,Transfer Charge + VAT,52.5,2363489.96,DEBIT
18/12/2017,"ISW/135605456866/1014794871/Jumbo pan production//MUHAMMAD,NAZIRU",110000.0,2253489.96,DEBIT
18/12/2017,7SACKS CHICKEN LAPS ON18THDEC//TRF TO SAYED FARMS LTD-ABUJA A/C,146000.0,2107489.96,DEBIT
19/12/2017,POS Settlement for2057FC999999440-19/12/2017,4400.0,2111889.96,CREDIT
19/12/2017,NEFT/INTERSWITCHNG/Goodsandservices19122,6550.5,2118440.46,CREDIT
19/12/2017,POS Settlement for2057FC999999440-19/12/2017,11100.0,2129540.46,CREDIT
19/12/2017,DS379185/CD/DEREK SHUAIB,278000.0,2407540.46,CREDIT
19/12/2017,POS Settlement Comm for2057FC999999440-19/12/2017,55.0,2407485.46,DEBIT
19/12/2017,POS Settlement Comm for2057FC999999440-19/12/2017,138.75,2407346.71,DEBIT
19/12/2017,MC BON PRESEVATIVEUTAKO//TRF TO EV MIRACLEBAKERS COMPANY NIG LTD,27000.0,2380346.71,DEBIT
19/12/2017,2 CARTONS BETA BAKERIMPROVER//TRF TO DAVISONNNAMEZIE,58000.0,2322346.71,DEBIT
19/12/2017,EMILY 10 CARTONS FRMUTAKO//TRF TO EV MIRACLEBAKERS COMPANY NIG LTD,73000.0,2249346.71,DEBIT
20/12/2017,POS Settlement for2057FC999999440-20/12/2017,5000.0,2258812.96,CREDIT
20/12/2017,ds340038/cd/habib mary,364500.0,2623312.96,CREDIT
20/12/2017,Transfer Charge + VAT,52.5,2623260.46,DEBIT
20/12/2017,Transfer Charge + VAT,52.5,2623207.96,DEBIT
20/12/2017,Transfer Charge + VAT,52.5,2623155.46,DEBIT
20/12/2017,POS Settlement Comm for2057FC999999440-20/12/2017,62.5,2623092.96,DEBIT
20/12/2017,ISW/135605462420/1014794871/Upfront//ATILOLA KOLA SAMSON,30000.0,2593092.96,DEBIT
20/12/2017,ISW/135605462705/1014794871/Okioil 5 and solive 5//EYA BROSS NIGLTD,94000.0,2499092.96,DEBIT
20/12/2017,ISW/135605462424/1014794871/Food items purchased on 14th//SUNDAYMICHIKA JOHN,129100.0,2369992.96,DEBIT
21/12/2017,NIP/ABN/SORAEOSAYANDE/FT//WOW BAK/SORAEO,4000.0,2373992.96,CREDIT
21/12/2017,NEFT/INTERSWITCHNG/Goodsandservices21122,4962.5,2378955.46,CREDIT
21/12/2017,DS99158/CD RUTH BABA,100000.0,2478955.46,CREDIT
21/12/2017,ds352199/cd/habib mary,530200.0,3009155.46,CREDIT
21/12/2017,Transfer Charge + VAT,52.5,3009102.96,DEBIT
21/12/2017,Transfer Charge + VAT,52.5,3009050.46,DEBIT
21/12/2017,ISW/135605466429/1014794871/Balfor habib signage//GODWINCHUKWUMA SUNDAY,15000.0,2994050.46,DEBIT
21/12/2017,BALANCE FOR RENOVATIONWORK//TRF TO MOSES ALABI,40000.0,2954050.46,DEBIT
21/12/2017,ISW/135605470534/1014794871/Refilfor last week and today//MAX GAS,44000.0,2910050.46,DEBIT
21/12/2017,"RICE,MAGGI AND SALT//TRF TOYUSUF   HARUNA",93300.0,2816750.46,DEBIT
22/12/2017,NIP/ABN/CHISOM YVONNENWADIUGWU/FT/Food/WOWBAK/CHISOM,1700.0,2818450.46,CREDIT
22/12/2017,NEFT/INTERSWITCHNG/Goodsandservices22122,8337.0,2829387.46,CREDIT
22/12/2017,POS Settlement for2057FC999999440-22/12/2017,15800.0,2845187.46,CREDIT
22/12/2017,36663 cd/ madam chinyere,80000.0,2925187.46,CREDIT
22/12/2017,DS 1362438 CD OLANIRAN SEUN,100000.0,3025187.46,CREDIT
22/12/2017,CD/DEREK SHUAIB/DS346966,305000.0,3330187.46,CREDIT
22/12/2017,Transfer Charge + VAT,52.5,3330134.96,DEBIT
22/12/2017,Transfer Charge + VAT,52.5,3330082.46,DEBIT
22/12/2017,Transfer Charge + VAT,52.5,3330029.96,DEBIT
22/12/2017,Transfer Charge + VAT,52.5,3329977.46,DEBIT
22/12/2017,POS Settlement Comm for2057FC999999440-22/12/2017,197.5,3329779.96,DEBIT
22/12/2017,STAMP DUTY CHARGE,1300.0,3328479.96,DEBIT
22/12/2017,ISW/135605470839/1014794871/Tpto otukpo//KWAME TWUM AMPOFO,10600.0,3317879.96,DEBIT
22/12/2017,ISW/135605470850/1014794871/20crates eggs supplied dismornin//SWIFT PLUS FARMS,18000.0,3299879.96,DEBIT
22/12/2017,ISW/135605476907/1014794871/Local chicken supplied today//ABDULLAHIMUSA,40000.0,3259879.96,DEBIT
22/12/2017,ISW/135605476915/1014794871/Pay//OYEWUNMI OLAWANDE,40000.0,3219879.96,DEBIT
22/12/2017,ITEAMS BROUGHT IN TODAY//TRFTO EV MIRACLE BAKERSCOMPANY NIG LTD,700000.0,2519879.96,DEBIT
23/12/2017,NIP/DBP/CHUKWU  GRACE/NIP -002174269868/TRF IFO WOWBAKERY CONFECTIONERY AND PA,1200.0,2521079.96,CREDIT
23/12/2017,"MC Loc ATM Pyt-000401914072--ATM4_PLOT 2001, TAFAWABALEWA AREA7 FC",25000.0,2546079.96,CREDIT
23/12/2017,CHICKEN LAPS 5SACKSTODAY//TRF TO SAYED FARMSLTD-ABUJA A/C,99000.0,2447079.96,DEBIT
24/12/2017,Rvsl:Transfer Charge + VAT,52.5,2447132.46,CREDIT
24/12/2017,NIP/ABN/STEPHEN CHIMAZURUNWAUKWA/FT//WOWBAK/STEPHEN,16000.0,2463132.46,CREDIT
24/12/2017,Transfer Charge + VAT,52.5,2519079.96,CREDIT
24/12/2017,Transfer Charge + VAT,52.5,2519027.46,DEBIT
24/12/2017,Transfer Charge + VAT,52.5,2518974.96,DEBIT
24/12/2017,Transfer Charge + VAT,52.5,2518922.46,DEBIT
24/12/2017,Transfer Charge + VAT,52.5,2518869.96,DEBIT
24/12/2017,Transfer Charge + VAT,52.5,2518817.46,DEBIT
24/12/2017,Transfer Charge + VAT,52.5,2518764.96,DEBIT
24/12/2017,ISW/135605480470/1014794871/Decpart//HABIB OJONIKO MARY,17500.0,2501264.96,DEBIT
24/12/2017,ISW/135605480458/1014794871/Partpayment for dec//ISHAKU  PIUS,21000.0,2480264.96,DEBIT
24/12/2017,PART//TRF TO MICHAEL OKOAKOBI,21000.0,2459264.96,DEBIT
24/12/2017,ISW/135605480467/1014794871/Balance for part payment//ADAMU LYDIA,25200.0,2434064.96,DEBIT
24/12/2017,ISW/135605479698/1014794871/Partpayment for gas refill//MAX GAS,56000.0,2378064.96,DEBIT
24/12/2017,ISW/135605480468/1014794871/Partfor cylinders//MAX GAS,56000.0,2322064.96,DEBIT
24/12/2017,ISW/135605480454/1014794871/Decpart payment//GADA  LUQMAN,70000.0,2252064.96,DEBIT
24/12/2017,ISW/135605480171/1014794871/Golden penny sugar 10//ABDULLAHISALIHU,165000.0,2087064.96,DEBIT
24/12/2017,DANO POWDERED MILK//TRF TOCAROLINE NGOZI ATTAH,182000.0,1905064.96,DEBIT
25/12/2017,NIP/FDP/KWAME TWUMAMPOFO/770 TRANSFER FROMKWAME TWUM AMPOFO **9,29000.0,1934064.96,CREDIT
25/12/2017,TRF FRM MARYANN IFEYINWA IKETO WOW BAKERYCONFECTIONERY AND PASTRIESNI,40000.0,1974064.96,CREDIT
25/12/2017,NIP/FBN/BENJAMIN EMEKAODOH/USSD_BENJAMIN EMEKAODOH,60000.0,2034064.96,CREDIT
25/12/2017,Transfer Charge + VAT,52.5,2034012.46,DEBIT
25/12/2017,ISW/135605480975/1014794871/Salary part for dec//GODSWILL DAVIDCHISCO,17500.0,2016512.46,DEBIT
27/12/2017,NEFT/INTERSWITCHNG/Goodsandservices27122,3275.25,2023062.96,CREDIT
27/12/2017,POS Settlement for2057FC999999440-27/12/2017,4900.0,2027962.96,CREDIT
27/12/2017,NEFT/INTERSWITCHNG/Goodsandservices24122,27095.26,2055058.22,CREDIT
27/12/2017,NEFT/INTERSWITCHNG/Goodsandservices25122,44215.88,2099274.1,CREDIT
27/12/2017,POS Settlement for2057FC999999440-27/12/2017,47450.0,2146724.1,CREDIT
27/12/2017,ds335475/cd/habib mary,269000.0,2415724.1,CREDIT
27/12/2017,DS113750/CD=BABA RUTH,1205350.0,3621074.1,CREDIT
27/12/2017,Transfer Charge + VAT,52.5,3621021.6,DEBIT
27/12/2017,Transfer Charge + VAT,52.5,3620969.1,DEBIT
27/12/2017,Transfer Charge + VAT,52.5,3620916.6,DEBIT
27/12/2017,POS Settlement Comm for2057FC999999440-27/12/2017,61.25,3620855.35,DEBIT
27/12/2017,POS Settlement Comm for2057FC999999440-27/12/2017,574.39,3620280.96,DEBIT
27/12/2017,ISW/135605494278/1014794871/20local chicken//ABDULLAHI MUSA,16000.0,3604280.96,DEBIT
27/12/2017,ISW/135605494247/1014794871/Balance for flour supplied lastwe//IBRAHIM  BAKO,800000.0,2804280.96,DEBIT
27/12/2017,ISW/135605482264/1014794871/Flour supplied on 17th//IBRAHIM  BAKO,1400000.0,1404280.96,DEBIT
28/12/2017,POS Settlement for2057FC999999440-28/12/2017,6100.0,1410380.96,CREDIT
28/12/2017,NEFT/INTERSWITCHNG/Goodsandservices28122,12902.51,1423283.47,CREDIT
28/12/2017,ds335485/cd/habib mary,419200.0,1842483.47,CREDIT
28/12/2017,POS Settlement Comm for2057FC999999440-28/12/2017,76.26,1842407.21,DEBIT
28/12/2017,10BAGS SUGAR UTAKO//TRF TOYUSUF   HARUNA,160000.0,1682407.21,DEBIT
29/12/2017,NIP/UBA/SHIAWOYA EMMANUELYEBO/MB/UTO/37856998/2348063915611/Trf to 1014794871,903.0,1683310.21,CREDIT
29/12/2017,POS Settlement for2057FC999999440-29/12/2017,6200.0,1693777.96,CREDIT
29/12/2017,Transfer Charge + VAT,52.5,1693725.46,DEBIT
29/12/2017,POS Settlement Comm for2057FC999999440-29/12/2017,77.5,1693647.96,DEBIT
29/12/2017,STATEMENT OF ACCOUNTCHARGE,903.0,1692744.96,DEBIT
29/12/2017,STAMP DUTY CHARGE,950.0,1691794.96,DEBIT
29/12/2017,EMBASSY LETTER CHARGE,2100.0,1689694.96,DEBIT
29/12/2017,ISW/135605499440/1014794871/IOU//KWAME TWUM AMPOFO,50000.0,1639694.96,DEBIT
29/12/2017,ITEAMS PURCHASED LASTWEEK//TRF TO EV MIRACLEBAKERS COMPANY NIG LTD,250000.0,1389694.96,DEBIT
30/12/2017,NIP/ABN/USMAN  TUKUR/FT//WOWBAK/USMAN,57200.0,1446894.96,CREDIT
30/12/2017,Transfer Charge + VAT,52.5,1446842.46,DEBIT
30/12/2017,IOU DEC//TRF TO MICHAEL OKOAKOBI,25000.0,1421842.46,DEBIT
30/12/2017,ISW/135605500854/1014794871/Tankbase//DSHOK ALEX,40000.0,1381842.46,DEBIT
30/12/2017,SUGAR 10BAGS TODAY//TRF TOYUSUF   HARUNA,160000.0,1221842.46,DEBIT
31/12/2017,Transfer Charge + VAT,52.5,1221789.96,DEBIT
31/12/2017,SMS Notification Charge Dec 2017,692.0,1221097.96,DEBIT
31/12/2017,Acct Maint. Fee + VAT,13010.8,1208087.16,DEBIT
31/12/2017,ISW/135605501395/1014794871/Salary iou//ADAMU LYDIA,20000.0,1188087.16,DEBIT
01/01/2018,Transfer Charge + VAT,52.5,1188034.66,DEBIT
01/01/2018,Transfer Charge + VAT,52.5,1187982.16,DEBIT
01/01/2018,ISW/135605502252/1014794871/Fanrepair//JIBRIN ODEKINA YUSUF,9000.0,1178982.16,DEBIT
01/01/2018,ISW/135605502251/1014794871/Drpaul 5bags//UGOMAT NIGENTERPRISES,165000.0,1013982.16,CREDIT
02/01/2018,NEFT/INTERSWITCHNG/Goodsandservices30122,1985.0,1015967.16,CREDIT
02/01/2018,POS Settlement for2057FC999999440-02/01/2018,3800.0,1019767.16,CREDIT
02/01/2018,NEFT/INTERSWITCHNG/Goodsandservices31122,20396.37,1048947.16,CREDIT
02/01/2018,ds196060/cd/derek shuaib,390500.0,1439447.16,CREDIT
02/01/2018,DS148597/CD BABA RUTH,1750820.0,3190267.16,CREDIT
02/01/2018,POS Settlement Comm for2057FC999999440-02/01/2018,47.51,3190219.65,CREDIT
02/01/2018,Transfer Charge + VAT,52.5,3190167.15,DEBIT
02/01/2018,Transfer Charge + VAT,52.5,3190114.65,DEBIT
02/01/2018,CAT FISH FOR TOMORROW//TRFTO MICHAEL OKO AKOBI,10750.0,3179364.65,DEBIT
02/01/2018,"ISW/135605503830/1014794871/Nil//BABA, DORCAS ZAINAB",60000.0,3119364.65,DEBIT
02/01/2018,"DANO,RICE AND PEAK//TRF TOYUSUF   HARUNA",200900.0,2918464.65,DEBIT
02/01/2018,ISW/135605504240/1014794871/Partpayment of last weeksupply//IBRAHIM  BAKO,1200000.0,1718464.65,DEBIT
03/01/2018,POS Settlement for2057FC999999440-03/01/2018,14600.0,1733064.65,CREDIT
03/01/2018,NEFT/INTERSWITCHNG/Goodsandservices03012,18410.88,1751475.53,CREDIT
03/01/2018,DS042366/CD/DEREK SHUAIB,569000.0,2320475.53,CREDIT
03/01/2018,POS Settlement Comm for2057FC999999440-03/01/2018,182.5,2320293.03,DEBIT
04/01/2018,POS Settlement for2057FC999999440-04/01/2018,2100.0,2322393.03,CREDIT
04/01/2018,NEFT/INTERSWITCHNG/Goodsandservices04012,6153.5,2328546.53,CREDIT
04/01/2018,ds400574/cd/derek shuaib,579000.0,2907546.53,CREDIT
04/01/2018,POS Settlement Comm for2057FC999999440-04/01/2018,26.25,2907520.28,DEBIT
04/01/2018,Transfer Charge + VAT,52.5,2907467.78,DEBIT
04/01/2018,Transfer Charge + VAT,52.5,2907415.28,DEBIT
04/01/2018,ISW/135605508288/1014794871/20crates supplied today//SWIFT PLUSFARMS PRODUCE L,18000.0,2889415.28,DEBIT
04/01/2018,ISW/135605508283/1014794871/Lesson fees//TSESE ERNEST,40000.0,2849415.28,DEBIT
05/01/2018,POS Settlement for2057FC999999440-05/01/2018,8900.0,2682315.28,CREDIT
05/01/2018,DS433306/CD/DEREK,303500.0,2985815.28,CREDIT
05/01/2018,POS Settlement Comm for2057FC999999440-05/01/2018,111.25,2985704.03,DEBIT
05/01/2018,STAMP DUTY CHARGE,750.0,2984954.03,DEBIT
05/01/2018,BETA BAKER 2 CARTONSTODAY//TRF TO DAVISONNNAMEZIE,58000.0,2926954.03,DEBIT
06/01/2018,Transfer Charge + VAT,52.5,2926901.53,DEBIT
06/01/2018,Transfer Charge + VAT,52.5,2926849.03,DEBIT
06/01/2018,Transfer Charge + VAT,52.5,2926796.53,DEBIT
06/01/2018,Transfer Charge + VAT,52.5,2926744.03,DEBIT
06/01/2018,Transfer Charge + VAT,52.5,2926691.53,DEBIT
06/01/2018,ISW/135605510698/1014794871/Decsalary balance//GADA  LUQMAN,30000.0,2896691.53,DEBIT
06/01/2018,ISW/135605510700/1014794871/Payment for Dec food supply//GODIYAYAKUBU,38400.0,2858291.53,DEBIT
06/01/2018,ISW/135605511151/1014794871/Balfor gas refill big&small//MAX GAS,52000.0,2806291.53,DEBIT
06/01/2018,ISW/135605511129/1014794871/Printing of bread nylon//AYODEJIAIYESIMI,100000.0,2706291.53,DEBIT
06/01/2018,SUPPLIED TODAY 7SACKS//TRF TOSAYED FARMS LTD-ABUJA A/C,146000.0,2560291.53,DEBIT
06/01/2018,ISW/135605510679/1014794871/Flour supply balance//IBRAHIM  BAKO,1000000.0,1560291.53,CREDIT
07/01/2018,"NIP/GTB/SOMADE  AYOBAMIWASIU/NIP FROM SOMADE,AYOBAMI WASIU TO WOW BAKERYCONFE",1200.0,1561491.53,CREDIT
07/01/2018,Transfer Charge + VAT,52.5,1561439.03,DEBIT
07/01/2018,Transfer Charge + VAT,52.5,1561386.53,DEBIT
07/01/2018,Transfer Charge + VAT,52.5,1561334.03,DEBIT
07/01/2018,Transfer Charge + VAT,52.5,1561281.53,DEBIT
07/01/2018,Transfer Charge + VAT,52.5,1561229.03,DEBIT
07/01/2018,Transfer Charge + VAT,52.5,1561176.53,DEBIT
07/01/2018,Transfer Charge + VAT,52.5,1561124.03,DEBIT
07/01/2018,ISW/135605512196/1014794871/Lastmonth bal//HABIB OJONIKO MARY,7500.0,1553571.53,CREDIT
07/01/2018,ISW/135605512189/1014794871/Payremaining//OZOGBO OLUCHI,9000.0,1544571.53,DEBIT
07/01/2018,PAY BALANCE//TRF TO JOHNSONMMADUABUCHI EGEMUKA,10500.0,1534071.53,DEBIT
07/01/2018,ISW/135605512195/1014794871/Salary bal for dec//ATILOLA KOLASAMSON,12000.0,1522071.53,DEBIT
07/01/2018,ISW/135605511720/1014794871/Decbalance//GODWIN JEREMIAHAKPABOT,15000.0,1507071.53,DEBIT
07/01/2018,ISW/135605511729/1014794871/Balremaining//UGOH VICTORCHUKWUDI,15000.0,1492071.53,DEBIT
07/01/2018,ISW/135605512186/1014794871/Partof repairs pay//JIBRIN ODEKINAYUSUF,15000.0,1477071.53,DEBIT
07/01/2018,ISW/135605512187/1014794871/Decbal pay//BULUS GHAI BABANGIDA,15000.0,1462071.53,DEBIT
07/01/2018,BAL OF SALARY//TRF TO AKOBIMATTHEW OGAR,15000.0,1447071.53,DEBIT
07/01/2018,ISW/135605511723/1014794871/Payment bal//JULIUS A OBARO,21000.0,1426071.53,DEBIT
07/01/2018,10BAGS DANGOTE SUGAR//TRF TOYUSUF   HARUNA,160000.0,1266071.53,DEBIT
08/01/2018,NEFT/INTERSWITCHNG/Goodsandservices07012,3076.75,1269148.28,CREDIT
08/01/2018,NEFT/INTERSWITCHNG/Goodsandservices08012,5558.0,1274706.28,CREDIT
08/01/2018,NEFT/INTERSWITCHNG/Goodsandservices06012,8535.5,1283241.78,CREDIT
08/01/2018,POS Settlement for2057FC999999440-08/01/2018,14800.0,1298041.78,CREDIT
08/01/2018,ds312605/cd pius ishaku,210230.0,1508271.78,CREDIT
08/01/2018,DS346419/CD/DEREK SHUAIB,430000.0,1938271.78,CREDIT
08/01/2018,Transfer Charge + VAT,52.5,1938219.28,DEBIT
08/01/2018,Transfer Charge + VAT,52.5,1938166.78,DEBIT
08/01/2018,POS Settlement Comm for2057FC999999440-08/01/2018,185.0,1937981.78,DEBIT
08/01/2018,ISW/135605512664/1014794871/Plumbing work part//NASIRU HARUNA,14000.0,1919981.78,CREDIT
09/01/2018,NEFT/INTERSWITCHNG/Goodsandservices09012,397.0,1920378.78,CREDIT
09/01/2018,ds 264753/cd/ derek s,755000.0,2675378.78,CREDIT
09/01/2018,Transfer Charge + VAT,52.5,2675326.28,DEBIT
09/01/2018,ISW/135605545766/1014794871/Tyres 2//OZOEMENA AGWU,13000.0,2662326.28,DEBIT
09/01/2018,EMILY 30CARTONS BOTHSHOPS//TRF TO EV MIRACLEBAKERS COMPANY NIG LTD,202500.0,2459826.28,DEBIT
10/01/2018,POS Settlement for2057FC999999440-10/01/2018,3050.0,2462876.28,CREDIT
10/01/2018,NEFT/INTERSWITCHNG/Goodsandservices10012,5558.0,2468434.28,CREDIT
10/01/2018,DS303454/CD BABA RUTH,100000.0,2568434.28,CREDIT
10/01/2018,ds408378/c dbaba ruth,451365.0,3019799.28,CREDIT
10/01/2018,POS Settlement Comm for2057FC999999440-10/01/2018,38.13,3019761.15,DEBIT
10/01/2018,SUGAR DANGOTE 10//TRF TOYUSUF   HARUNA,160000.0,2859761.15,DEBIT
11/01/2018,POS Settlement for2057FC999999440-11/01/2018,1200.0,2860961.15,CREDIT
11/01/2018,NEFT/INTERSWITCHNG/Goodsandservices11012,3275.25,2864236.4,CREDIT
11/01/2018,TRF FRM DEBORAH SHIAWOYA TOWOW BAKERY CONFECTIONERYAND PASTRIES NI|trf frm deb,13000.0,2877236.4,CREDIT
11/01/2018,POS Settlement Comm for2057FC999999440-11/01/2018,15.0,2877221.4,DEBIT
12/01/2018,NEFT/INTERSWITCHNG/Goodsandservices12012,1091.75,2878313.15,CREDIT
12/01/2018,DS389931/CD/DEREK SHUAIB,497000.0,3375313.15,CREDIT
12/01/2018,STAMP DUTY CHARGE,850.0,3374463.15,DEBIT
13/01/2018,NIP/ABN/CHIOMA CHARLESEBOH/FT//WOW BAK/CHIOMA,950.0,3375413.15,CREDIT
13/01/2018,NIP/DBP/KAYODE R APATA/NIP -002257298558/TRF IFO WOWBAKERY CONFECTIONERY AND P,4350.0,3379763.15,CREDIT
13/01/2018,Transfer Charge + VAT,52.5,3385110.65,CREDIT
13/01/2018,Transfer Charge + VAT,52.5,3385058.15,DEBIT
13/01/2018,ISW/135605562730/1014794871/Shop iteams frm utako//SUNDAYMICHIKA JOHN,202000.0,3183058.15,DEBIT
13/01/2018,ISW/135605562723/1014794871/Flour mamag//IBRAHIM  BAKO,1200000.0,1983058.15,DEBIT
14/01/2018,Rvsl:Transfer Charge + VAT,52.5,1983110.65,CREDIT
14/01/2018,Rvsl:ISW/135605563651/1014794871/Mama gold bal//IBRAHIM  BAKO,1000000.0,2983110.65,CREDIT
14/01/2018,Transfer Charge + VAT,52.5,2983058.15,DEBIT
14/01/2018,Transfer Charge + VAT,52.5,2983005.65,DEBIT
14/01/2018,50KG DANO POWDERED//TRF TOCAROLINE NGOZI ATTAH,175000.0,2808005.65,DEBIT
14/01/2018,ISW/135605563651/1014794871/Mama gold bal//IBRAHIM  BAKO,1000000.0,1808005.65,DEBIT
14/01/2018,ISW/135605563869/1014794871/Mama G bal//IBRAHIM  BAKO,1000000.0,808005.65,CREDIT
15/01/2018,POS Settlement for2057FC999999440-15/01/2018,3100.0,811105.65,CREDIT
15/01/2018,POS Settlement for2057FC999999440-15/01/2018,6200.0,817305.65,CREDIT
15/01/2018,NEFT/INTERSWITCHNG/Goodsandservices13012,6352.0,823657.65,CREDIT
15/01/2018,DS616311/CD BABA RUTH,336000.0,1159657.65,CREDIT
15/01/2018,CD/DEREK S/DS360420,488000.0,1647657.65,CREDIT
15/01/2018,POS Settlement Comm for2057FC999999440-15/01/2018,38.75,1647618.9,DEBIT
15/01/2018,Transfer Charge + VAT,52.5,1647566.4,DEBIT
15/01/2018,POS Settlement Comm for2057FC999999440-15/01/2018,77.5,1647488.9,DEBIT
15/01/2018,ISW/135605566118/1014794871/Preserv frm jtown//UGOMAT NIGENTERPRISES,163000.0,1484488.9,DEBIT
15/01/2018,5BAGS SALT&SUGAR 10//TRF TOYUSUF   HARUNA,171000.0,1313488.9,DEBIT
16/01/2018,NEFT/INTERSWITCHNG/Goodsandservices14012,2878.25,1316367.15,CREDIT
16/01/2018,NEFT/INTERSWITCHNG/Goodsandservices16012,3970.0,1323537.15,CREDIT
16/01/2018,NEFT/INTERSWITCHNG/Goodsandservices15012,7543.0,1331080.15,CREDIT
16/01/2018,278830cd/mr oyo umazayi,23300.0,1354380.15,CREDIT
16/01/2018,NIP/FBN/CARE & CUDDLESKINDERGARTEN/FBNMOBILE:WOWBAKERY CONFECTIONERY ANDPASTR,61500.0,1415880.15,CREDIT
16/01/2018,ds732329/cd=ruth baba,751000.0,2166880.15,CREDIT
16/01/2018,POS Settlement Comm for2057FC999999440-16/01/2018,40.0,2166840.15,DEBIT
17/01/2018,NEFT/INTERSWITCHNG/Goodsandservices17012,2580.5,2169420.65,CREDIT
17/01/2018,DS732342/CD BABA RUTH,83000.0,2252420.65,CREDIT
17/01/2018,Transfer Charge + VAT,52.5,2252368.15,DEBIT
17/01/2018,"ISW/135605569919/1014794871/Tithes for December//GEN. ACCT FORTITHES, OFFERI",75000.0,2177368.15,DEBIT
17/01/2018,CHICKEN LAPS FROZEN//TRF TOSAYED FARMS LTD-ABUJA A/C,132000.0,2045368.15,DEBIT
17/01/2018,SUGAR FRM UTAKO//TRF TOYUSUF   HARUNA,160000.0,1885368.15,DEBIT
18/01/2018,POS Settlement for2057FC999999440-18/01/2018,2000.0,1887368.15,CREDIT
18/01/2018,NEFT/INTERSWITCHNG/Goodsandservices18012,6649.75,1894017.9,CREDIT
18/01/2018,cd/derek s/ds720121,509660.0,2403677.9,CREDIT
18/01/2018,POS Settlement Comm for2057FC999999440-18/01/2018,25.0,2403652.9,DEBIT
19/01/2018,RvPosNotOnusFEE 17110913324009/11/2017,7.87,2403660.77,CREDIT
19/01/2018,TRF FRM ONYEKA   IGWEATU TOWOW BAKERY CONFECTIONERYAND PASTRIES NI,1000.0,2404660.77,CREDIT
19/01/2018,NEFT/INTERSWITCHNG/Goodsandservices19012,6550.5,2411211.27,CREDIT
19/01/2018,POS Settlement for2057FC999999440-19/01/2018,8500.0,2419711.27,CREDIT
19/01/2018,CD/DEREK S/DS403194,321500.0,2741211.27,CREDIT
19/01/2018,Transfer Charge + VAT,52.5,2741106.27,CREDIT
19/01/2018,Transfer Charge + VAT,52.5,2741053.77,DEBIT
19/01/2018,POS Settlement Comm for2057FC999999440-19/01/2018,106.25,2740947.52,DEBIT
19/01/2018,RvPosNoOnusTx 17110913324009/11/2017,1050.0,2739897.52,DEBIT
19/01/2018,STAMP DUTY CHARGE,1150.0,2738747.52,DEBIT
19/01/2018,DRIED FISH//TRF TO WODUSHIAWOYA GRACE,17000.0,2721747.52,DEBIT
19/01/2018,ISW/135605572976/1014794871/Oki5gallons//EYA BROSS NIG LTD,59000.0,2662747.52,DEBIT
19/01/2018,ISW/135605572914/1014794871/Big3&4 small refill//MAX GAS,64000.0,2598747.52,DEBIT
19/01/2018,ISW/135605574882/1014794871/Golden penny last week//IBRAHIM  BAKO,922250.0,1676497.52,DEBIT
20/01/2018,Transfer Charge + VAT,52.5,1676445.02,DEBIT
20/01/2018,Transfer Charge + VAT,52.5,1676392.52,DEBIT
20/01/2018,ISW/135605575604/1014794871/Feesfor jan//A.Y. USMAN CONSULTINGLIMITED,10000.0,1666392.52,DEBIT
20/01/2018,"ISW/135605575349/1014794871/3cartons ice cream mix//OJO, OLAKANMINATHANIEL",90000.0,1576392.52,DEBIT
22/01/2018,NEFT/INTERSWITCHNG/Goodsandservices22012,2183.5,1578576.02,CREDIT
22/01/2018,NEFT/INTERSWITCHNG/Goodsandservices20012,4466.25,1583042.27,CREDIT
22/01/2018,NEFT/INTERSWITCHNG/Goodsandservices21012,11910.01,1594952.28,CREDIT
22/01/2018,POS Settlement for2057FC999999440-22/01/2018,25700.0,1620652.28,CREDIT
22/01/2018,CD/DEREK S/DS551531,238000.0,1858652.28,CREDIT
22/01/2018,DS763502/CD=RUTH BABA,900000.0,2758652.28,CREDIT
22/01/2018,Transfer Charge + VAT,52.5,2758599.78,DEBIT
22/01/2018,POS Settlement Comm for2057FC999999440-22/01/2018,321.26,2758278.52,DEBIT
22/01/2018,"MILK,SUGAR AND SALT//TRF TOYUSUF   HARUNA",342500.0,2415778.52,DEBIT
23/01/2018,NEFT/INTERSWITCHNG/Goodsandservices23012,2779.0,1918557.52,CREDIT
23/01/2018,POS Settlement for2057FC999999440-23/01/2018,3000.0,1921557.52,CREDIT
23/01/2018,POS Settlement Comm for2057FC999999440-23/01/2018,37.5,1921520.02,DEBIT
23/01/2018,Transfer Charge + VAT,52.5,1921467.52,DEBIT
23/01/2018,ISW/135605581085/1014794871/Balfor fan repairs//JIBRIN ODEKINAYUSUF,6000.0,1915467.52,DEBIT
24/01/2018,NEFT/INTERSWITCHNG/Goodsandservices24012,3920.38,1919387.9,CREDIT
24/01/2018,POS Settlement for2057FC999999440-24/01/2018,4700.0,1924087.9,CREDIT
24/01/2018,ds573594/cd ruth baba,175000.0,2099087.9,CREDIT
24/01/2018,ds455263/cd/derek shuiab,657000.0,2756087.9,CREDIT
24/01/2018,POS Settlement Comm for2057FC999999440-24/01/2018,58.75,2756029.15,DEBIT
25/01/2018,POS Settlement for2057FC999999440-25/01/2018,2900.0,2758929.15,CREDIT
25/01/2018,NEFT/INTERSWITCHNG/Goodsandservices25012,9279.88,2768209.03,CREDIT
25/01/2018,CD/DEREK S/DS783979,436000.0,3204209.03,CREDIT
25/01/2018,POS Settlement Comm for2057FC999999440-25/01/2018,36.25,3204172.78,DEBIT
25/01/2018,Transfer Charge + VAT,52.5,3204120.28,DEBIT
25/01/2018,Interbank + VAT Charge,52.5,3204067.78,DEBIT
25/01/2018,Transfer Charge + VAT,52.5,3204015.28,DEBIT
25/01/2018,Transfer Charge + VAT,52.5,3203962.78,DEBIT
25/01/2018,ISW/135605585150/1014794871/Upfront salary//BULUS GHAI BABANGIDA,10000.0,3193962.78,DEBIT
25/01/2018,ISW/135605584944/1014794871/Janupfront//ATILOLA KOLA SAMSON,30000.0,3163962.78,DEBIT
25/01/2018,ISW/135605583817/1014794871/Bigfoil 2&ketcup bowl//BENITA MERCYOBI,34000.0,3129962.78,DEBIT
25/01/2018,Jumbo nylon//NEFT TRF TOVIVO&TECH INDUSTRIES LIMITED,100000.0,3029962.78,DEBIT
26/01/2018,POS Settlement for2057FC999999440-26/01/2018,8150.0,2871912.78,CREDIT
26/01/2018,NEFT/INTERSWITCHNG/Goodsandservices26012,17021.39,2888934.17,CREDIT
26/01/2018,CD/DEREK S/DS349266,250500.0,3139434.17,CREDIT
26/01/2018,Transfer Charge + VAT,52.5,3139381.67,DEBIT
26/01/2018,Transfer Charge + VAT,52.5,3139329.17,DEBIT
26/01/2018,Transfer Charge + VAT,52.5,3139276.67,DEBIT
26/01/2018,POS Settlement Comm for2057FC999999440-26/01/2018,101.88,3139174.79,DEBIT
26/01/2018,STAMP DUTY CHARGE,900.0,3138274.79,DEBIT
26/01/2018,CB POS ACQ VC-171109133439-09/11/2017,1000.0,3137274.79,DEBIT
26/01/2018,CB POS ACQ VC-171107092237-07/11/2017,3000.0,3134274.79,DEBIT
26/01/2018,ISW/135605608021/1014794871/Lastmonth pay//SULEIMAN BOLA OTEGA,11500.0,3122774.79,DEBIT
26/01/2018,ISW/135605586134/1014794871/20crates yesterday//SWIFT PLUS FARMSPRODUCE LIMITED,18000.0,3104774.79,DEBIT
26/01/2018,ISW/135605586090/1014794871/Genservice//IHEANACHO ANTHONYEWUZIE,26000.0,3078774.79,DEBIT
26/01/2018,CB POS ACQ VC-000013029066-28/12/2017,132550.0,2946224.79,DEBIT
26/01/2018,SACK OF LAPS 7//TRF TO SAYEDFARMS LTD-ABUJA A/C,135000.0,2811224.79,DEBIT
27/01/2018,Transfer Charge + VAT,52.5,2811172.29,DEBIT
27/01/2018,SMS Notification Charge Jan 2018,440.0,2810732.29,DEBIT
27/01/2018,ISW/135605608865/1014794871/2cartons of satis beef//SHAIKA DANSUMA,23600.0,2787132.29,DEBIT
29/01/2018,NEFT/INTERSWITCHNG/Goodsandservices28012,4218.13,2791350.42,CREDIT
29/01/2018,NEFT/INTERSWITCHNG/Goodsandservices29012,9279.89,2800630.31,CREDIT
29/01/2018,NEFT/INTERSWITCHNG/Goodsandservices27012,29973.52,2830603.83,CREDIT
29/01/2018,POS Settlement for2057FC999999440-29/01/2018,52900.0,2883503.83,CREDIT
29/01/2018,CD/DEREK S/DS405071,325000.0,3208503.83,CREDIT
29/01/2018,Transfer Charge + VAT,52.5,3208398.83,CREDIT
29/01/2018,Transfer Charge + VAT,52.5,3208346.33,DEBIT
29/01/2018,POS Settlement Comm for2057FC999999440-29/01/2018,661.29,3207685.04,DEBIT
29/01/2018,ISW/135605612679/1014794871/Eggs 20 today//SWIFT PLUS FARMSPRODUCE LIMITED,18000.0,3189685.04,DEBIT
29/01/2018,ISW/135605612686/1014794871/Ibig&5small refill//MAX GAS,36000.0,3153685.04,DEBIT
29/01/2018,ISW/135605610337/1014794871/Solive oil 5kegs//EYA BROSS NIG LTD,39000.0,3114685.04,DEBIT
29/01/2018,5SALT 6DANO 10SUGAR//TRF TOYUSUF   HARUNA,313000.0,2801685.04,DEBIT
30/01/2018,DS431843/CD RUTH BABA,217000.0,3018685.04,CREDIT
